Patent Applications Total,"Patent and Trade Mark Applications, total",AVG Government expenditure on education,Country,Country Code,government expenditure on education pc of GDP,Gross Enrollment Ratio Terciary Both Sexes,Patent Applications Nonresident,Patent Applications Resident,Region,Trademark Applications Total,Year
2301,22645,5.6,Austria,AUT,5.6,56.573,340,1961,Europe,20344,2000
2301,22645,5.6,Austria,AUT,5.6,56.573,340,1961,Europe,20344,2000
2301,22645,5.6,Austria,AUT,5.6,56.573,340,1961,Europe,20344,2000
2301,22645,5.6,Austria,AUT,5.6,56.573,340,1961,Europe,20344,2000
2301,22645,5.6,Austria,AUT,5.6,56.573,340,1961,Europe,20344,2000
2301,22645,5.6,Austria,AUT,5.6,56.573,340,1961,Europe,20344,2000
2301,22645,5.6,Austria,AUT,5.6,56.573,340,1961,Europe,20344,2000
820,37542,4.1499375,Belgium,BEL,0,57.55,243,577,Europe,36722,2000
820,37542,4.1499375,Belgium,BEL,0,57.55,243,577,Europe,36722,2000
820,37542,4.1499375,Belgium,BEL,0,57.55,243,577,Europe,36722,2000
820,37542,4.1499375,Belgium,BEL,0,57.55,243,577,Europe,36722,2000
820,37542,4.1499375,Belgium,BEL,0,57.55,243,577,Europe,36722,2000
820,37542,4.1499375,Belgium,BEL,0,57.55,243,577,Europe,36722,2000
820,37542,4.1499375,Belgium,BEL,0,57.55,243,577,Europe,36722,2000
1870,14303,8.084,Denmark,DNK,8.084,57.249,140,1730,Europe,12433,2000
1870,14303,8.084,Denmark,DNK,8.084,57.249,140,1730,Europe,12433,2000
1870,14303,8.084,Denmark,DNK,8.084,57.249,140,1730,Europe,12433,2000
1870,14303,8.084,Denmark,DNK,8.084,57.249,140,1730,Europe,12433,2000
1870,14303,8.084,Denmark,DNK,8.084,57.249,140,1730,Europe,12433,2000
1870,14303,8.084,Denmark,DNK,8.084,57.249,140,1730,Europe,12433,2000
1870,14303,8.084,Denmark,DNK,8.084,57.249,140,1730,Europe,12433,2000
2903,13378,5.717,Finland,FIN,5.717,82.439,324,2579,Europe,10475,2000
2903,13378,5.717,Finland,FIN,5.717,82.439,324,2579,Europe,10475,2000
2903,13378,5.717,Finland,FIN,5.717,82.439,324,2579,Europe,10475,2000
2903,13378,5.717,Finland,FIN,5.717,82.439,324,2579,Europe,10475,2000
2903,13378,5.717,Finland,FIN,5.717,82.439,324,2579,Europe,10475,2000
2903,13378,5.717,Finland,FIN,5.717,82.439,324,2579,Europe,10475,2000
2903,13378,5.717,Finland,FIN,5.717,82.439,324,2579,Europe,10475,2000
876,8252,6.487,Iceland,ISL,6.487,45.481,825,51,Europe,7376,2000
876,8252,6.487,Iceland,ISL,6.487,45.481,825,51,Europe,7376,2000
876,8252,6.487,Iceland,ISL,6.487,45.481,825,51,Europe,7376,2000
876,8252,6.487,Iceland,ISL,6.487,45.481,825,51,Europe,7376,2000
876,8252,6.487,Iceland,ISL,6.487,45.481,825,51,Europe,7376,2000
876,8252,6.487,Iceland,ISL,6.487,45.481,825,51,Europe,7376,2000
876,8252,6.487,Iceland,ISL,6.487,45.481,825,51,Europe,7376,2000
127,7141,8.6955,Lithuania,LTU,0,50.264,61,66,Europe,7014,2000
127,7141,8.6955,Lithuania,LTU,0,50.264,61,66,Europe,7014,2000
127,7141,8.6955,Lithuania,LTU,0,50.264,61,66,Europe,7014,2000
127,7141,8.6955,Lithuania,LTU,0,50.264,61,66,Europe,7014,2000
127,7141,8.6955,Lithuania,LTU,0,50.264,61,66,Europe,7014,2000
127,7141,8.6955,Lithuania,LTU,0,50.264,61,66,Europe,7014,2000
127,7141,8.6955,Lithuania,LTU,0,50.264,61,66,Europe,7014,2000
2994,2994,4.619,Netherlands,NLD,4.619,53,529,2465,Europe,0,2000
2994,2994,4.619,Netherlands,NLD,4.619,53,529,2465,Europe,0,2000
2994,2994,4.619,Netherlands,NLD,4.619,53,529,2465,Europe,0,2000
2994,2994,4.619,Netherlands,NLD,4.619,53,529,2465,Europe,0,2000
2994,2994,4.619,Netherlands,NLD,4.619,53,529,2465,Europe,0,2000
2994,2994,4.619,Netherlands,NLD,4.619,53,529,2465,Europe,0,2000
2994,2994,4.619,Netherlands,NLD,4.619,53,529,2465,Europe,0,2000
6700,23049,6.465,Norway,NOR,6.465,69.342,5389,1311,Europe,16349,2000
6700,23049,6.465,Norway,NOR,6.465,69.342,5389,1311,Europe,16349,2000
6700,23049,6.465,Norway,NOR,6.465,69.342,5389,1311,Europe,16349,2000
6700,23049,6.465,Norway,NOR,6.465,69.342,5389,1311,Europe,16349,2000
6700,23049,6.465,Norway,NOR,6.465,69.342,5389,1311,Europe,16349,2000
6700,23049,6.465,Norway,NOR,6.465,69.342,5389,1311,Europe,16349,2000
6700,23049,6.465,Norway,NOR,6.465,69.342,5389,1311,Europe,16349,2000
431,8959,4.1545625,Slovenia,SVN,0,55.21,124,307,Europe,8528,2000
431,8959,4.1545625,Slovenia,SVN,0,55.21,124,307,Europe,8528,2000
431,8959,4.1545625,Slovenia,SVN,0,55.21,124,307,Europe,8528,2000
431,8959,4.1545625,Slovenia,SVN,0,55.21,124,307,Europe,8528,2000
431,8959,4.1545625,Slovenia,SVN,0,55.21,124,307,Europe,8528,2000
431,8959,4.1545625,Slovenia,SVN,0,55.21,124,307,Europe,8528,2000
431,8959,4.1545625,Slovenia,SVN,0,55.21,124,307,Europe,8528,2000
5068,21737,6.819,Sweden,SWE,6.819,67.106,844,4224,Europe,16669,2000
5068,21737,6.819,Sweden,SWE,6.819,67.106,844,4224,Europe,16669,2000
5068,21737,6.819,Sweden,SWE,6.819,67.106,844,4224,Europe,16669,2000
5068,21737,6.819,Sweden,SWE,6.819,67.106,844,4224,Europe,16669,2000
5068,21737,6.819,Sweden,SWE,6.819,67.106,844,4224,Europe,16669,2000
5068,21737,6.819,Sweden,SWE,6.819,67.106,844,4224,Europe,16669,2000
5068,21737,6.819,Sweden,SWE,6.819,67.106,844,4224,Europe,16669,2000
7224,18540,4.166,Ukraine,UKR,4.166,48.703,1604,5620,Europe,11316,2000
7224,18540,4.166,Ukraine,UKR,4.166,48.703,1604,5620,Europe,11316,2000
7224,18540,4.166,Ukraine,UKR,4.166,48.703,1604,5620,Europe,11316,2000
7224,18540,4.166,Ukraine,UKR,4.166,48.703,1604,5620,Europe,11316,2000
7224,18540,4.166,Ukraine,UKR,4.166,48.703,1604,5620,Europe,11316,2000
7224,18540,4.166,Ukraine,UKR,4.166,48.703,1604,5620,Europe,11316,2000
7224,18540,4.166,Ukraine,UKR,4.166,48.703,1604,5620,Europe,11316,2000
32747,75278,4.352,United Kingdom,GBR,4.352,58.524,10697,22050,Europe,42531,2000
32747,75278,4.352,United Kingdom,GBR,4.352,58.524,10697,22050,Europe,42531,2000
32747,75278,4.352,United Kingdom,GBR,4.352,58.524,10697,22050,Europe,42531,2000
32747,75278,4.352,United Kingdom,GBR,4.352,58.524,10697,22050,Europe,42531,2000
32747,75278,4.352,United Kingdom,GBR,4.352,58.524,10697,22050,Europe,42531,2000
32747,75278,4.352,United Kingdom,GBR,4.352,58.524,10697,22050,Europe,42531,2000
32747,75278,4.352,United Kingdom,GBR,4.352,58.524,10697,22050,Europe,42531,2000
2099,21461,5.586,Austria,AUT,5.586,56.806,284,1815,Europe,19362,2001
2099,21461,5.586,Austria,AUT,5.586,56.806,284,1815,Europe,19362,2001
2099,21461,5.586,Austria,AUT,5.586,56.806,284,1815,Europe,19362,2001
2099,21461,5.586,Austria,AUT,5.586,56.806,284,1815,Europe,19362,2001
2099,21461,5.586,Austria,AUT,5.586,56.806,284,1815,Europe,19362,2001
2099,21461,5.586,Austria,AUT,5.586,56.806,284,1815,Europe,19362,2001
2099,21461,5.586,Austria,AUT,5.586,56.806,284,1815,Europe,19362,2001
835,34761,5.854,Belgium,BEL,5.854,58.245,264,571,Europe,33926,2001
835,34761,5.854,Belgium,BEL,5.854,58.245,264,571,Europe,33926,2001
835,34761,5.854,Belgium,BEL,5.854,58.245,264,571,Europe,33926,2001
835,34761,5.854,Belgium,BEL,5.854,58.245,264,571,Europe,33926,2001
835,34761,5.854,Belgium,BEL,5.854,58.245,264,571,Europe,33926,2001
835,34761,5.854,Belgium,BEL,5.854,58.245,264,571,Europe,33926,2001
835,34761,5.854,Belgium,BEL,5.854,58.245,264,571,Europe,33926,2001
1945,13929,8.215,Denmark,DNK,8.215,60.028,188,1757,Europe,11984,2001
1945,13929,8.215,Denmark,DNK,8.215,60.028,188,1757,Europe,11984,2001
1945,13929,8.215,Denmark,DNK,8.215,60.028,188,1757,Europe,11984,2001
1945,13929,8.215,Denmark,DNK,8.215,60.028,188,1757,Europe,11984,2001
1945,13929,8.215,Denmark,DNK,8.215,60.028,188,1757,Europe,11984,2001
1945,13929,8.215,Denmark,DNK,8.215,60.028,188,1757,Europe,11984,2001
1945,13929,8.215,Denmark,DNK,8.215,60.028,188,1757,Europe,11984,2001
2660,12904,5.848,Finland,FIN,5.848,84.431,270,2390,Europe,10244,2001
2660,12904,5.848,Finland,FIN,5.848,84.431,270,2390,Europe,10244,2001
2660,12904,5.848,Finland,FIN,5.848,84.431,270,2390,Europe,10244,2001
2660,12904,5.848,Finland,FIN,5.848,84.431,270,2390,Europe,10244,2001
2660,12904,5.848,Finland,FIN,5.848,84.431,270,2390,Europe,10244,2001
2660,12904,5.848,Finland,FIN,5.848,84.431,270,2390,Europe,10244,2001
2660,12904,5.848,Finland,FIN,5.848,84.431,270,2390,Europe,10244,2001
762,4733,6.778,Iceland,ISL,6.778,47.64,713,49,Europe,3971,2001
762,4733,6.778,Iceland,ISL,6.778,47.64,713,49,Europe,3971,2001
762,4733,6.778,Iceland,ISL,6.778,47.64,713,49,Europe,3971,2001
762,4733,6.778,Iceland,ISL,6.778,47.64,713,49,Europe,3971,2001
762,4733,6.778,Iceland,ISL,6.778,47.64,713,49,Europe,3971,2001
762,4733,6.778,Iceland,ISL,6.778,47.64,713,49,Europe,3971,2001
762,4733,6.778,Iceland,ISL,6.778,47.64,713,49,Europe,3971,2001
123,7440,8.6955,Lithuania,LTU,0,55.76,55,68,Europe,7317,2001
123,7440,8.6955,Lithuania,LTU,0,55.76,55,68,Europe,7317,2001
123,7440,8.6955,Lithuania,LTU,0,55.76,55,68,Europe,7317,2001
123,7440,8.6955,Lithuania,LTU,0,55.76,55,68,Europe,7317,2001
123,7440,8.6955,Lithuania,LTU,0,55.76,55,68,Europe,7317,2001
123,7440,8.6955,Lithuania,LTU,0,55.76,55,68,Europe,7317,2001
123,7440,8.6955,Lithuania,LTU,0,55.76,55,68,Europe,7317,2001
2653,2653,4.756,Netherlands,NLD,4.756,55.097,543,2110,Europe,0,2001
2653,2653,4.756,Netherlands,NLD,4.756,55.097,543,2110,Europe,0,2001
2653,2653,4.756,Netherlands,NLD,4.756,55.097,543,2110,Europe,0,2001
2653,2653,4.756,Netherlands,NLD,4.756,55.097,543,2110,Europe,0,2001
2653,2653,4.756,Netherlands,NLD,4.756,55.097,543,2110,Europe,0,2001
2653,2653,4.756,Netherlands,NLD,4.756,55.097,543,2110,Europe,0,2001
2653,2653,4.756,Netherlands,NLD,4.756,55.097,543,2110,Europe,0,2001
6431,21510,6.829,Norway,NOR,6.829,70.28,5242,1189,Europe,15079,2001
6431,21510,6.829,Norway,NOR,6.829,70.28,5242,1189,Europe,15079,2001
6431,21510,6.829,Norway,NOR,6.829,70.28,5242,1189,Europe,15079,2001
6431,21510,6.829,Norway,NOR,6.829,70.28,5242,1189,Europe,15079,2001
6431,21510,6.829,Norway,NOR,6.829,70.28,5242,1189,Europe,15079,2001
6431,21510,6.829,Norway,NOR,6.829,70.28,5242,1189,Europe,15079,2001
6431,21510,6.829,Norway,NOR,6.829,70.28,5242,1189,Europe,15079,2001
408,8898,5.757,Slovenia,SVN,5.757,60.446,107,301,Europe,8490,2001
408,8898,5.757,Slovenia,SVN,5.757,60.446,107,301,Europe,8490,2001
408,8898,5.757,Slovenia,SVN,5.757,60.446,107,301,Europe,8490,2001
408,8898,5.757,Slovenia,SVN,5.757,60.446,107,301,Europe,8490,2001
408,8898,5.757,Slovenia,SVN,5.757,60.446,107,301,Europe,8490,2001
408,8898,5.757,Slovenia,SVN,5.757,60.446,107,301,Europe,8490,2001
408,8898,5.757,Slovenia,SVN,5.757,60.446,107,301,Europe,8490,2001
4500,19661,6.686,Sweden,SWE,6.686,70.296,574,3926,Europe,15161,2001
4500,19661,6.686,Sweden,SWE,6.686,70.296,574,3926,Europe,15161,2001
4500,19661,6.686,Sweden,SWE,6.686,70.296,574,3926,Europe,15161,2001
4500,19661,6.686,Sweden,SWE,6.686,70.296,574,3926,Europe,15161,2001
4500,19661,6.686,Sweden,SWE,6.686,70.296,574,3926,Europe,15161,2001
4500,19661,6.686,Sweden,SWE,6.686,70.296,574,3926,Europe,15161,2001
4500,19661,6.686,Sweden,SWE,6.686,70.296,574,3926,Europe,15161,2001
8818,22992,4.68,Ukraine,UKR,4.68,51.867,1610,7208,Europe,14174,2001
8818,22992,4.68,Ukraine,UKR,4.68,51.867,1610,7208,Europe,14174,2001
8818,22992,4.68,Ukraine,UKR,4.68,51.867,1610,7208,Europe,14174,2001
8818,22992,4.68,Ukraine,UKR,4.68,51.867,1610,7208,Europe,14174,2001
8818,22992,4.68,Ukraine,UKR,4.68,51.867,1610,7208,Europe,14174,2001
8818,22992,4.68,Ukraine,UKR,4.68,51.867,1610,7208,Europe,14174,2001
8818,22992,4.68,Ukraine,UKR,4.68,51.867,1610,7208,Europe,14174,2001
32081,69535,4.41,United Kingdom,GBR,4.41,59.309,10658,21423,Europe,37454,2001
32081,69535,4.41,United Kingdom,GBR,4.41,59.309,10658,21423,Europe,37454,2001
32081,69535,4.41,United Kingdom,GBR,4.41,59.309,10658,21423,Europe,37454,2001
32081,69535,4.41,United Kingdom,GBR,4.41,59.309,10658,21423,Europe,37454,2001
32081,69535,4.41,United Kingdom,GBR,4.41,59.309,10658,21423,Europe,37454,2001
32081,69535,4.41,United Kingdom,GBR,4.41,59.309,10658,21423,Europe,37454,2001
32081,69535,4.41,United Kingdom,GBR,4.41,59.309,10658,21423,Europe,37454,2001
2261,19529,5.533,Austria,AUT,5.533,46.535,329,1932,Europe,17268,2002
2261,19529,5.533,Austria,AUT,5.533,46.535,329,1932,Europe,17268,2002
2261,19529,5.533,Austria,AUT,5.533,46.535,329,1932,Europe,17268,2002
2261,19529,5.533,Austria,AUT,5.533,46.535,329,1932,Europe,17268,2002
2261,19529,5.533,Austria,AUT,5.533,46.535,329,1932,Europe,17268,2002
2261,19529,5.533,Austria,AUT,5.533,46.535,329,1932,Europe,17268,2002
2261,19529,5.533,Austria,AUT,5.533,46.535,329,1932,Europe,17268,2002
748,32504,5.958,Belgium,BEL,5.958,59.116,147,601,Europe,31756,2002
748,32504,5.958,Belgium,BEL,5.958,59.116,147,601,Europe,31756,2002
748,32504,5.958,Belgium,BEL,5.958,59.116,147,601,Europe,31756,2002
748,32504,5.958,Belgium,BEL,5.958,59.116,147,601,Europe,31756,2002
748,32504,5.958,Belgium,BEL,5.958,59.116,147,601,Europe,31756,2002
748,32504,5.958,Belgium,BEL,5.958,59.116,147,601,Europe,31756,2002
748,32504,5.958,Belgium,BEL,5.958,59.116,147,601,Europe,31756,2002
1984,12646,8.213,Denmark,DNK,8.213,63.534,169,1815,Europe,10662,2002
1984,12646,8.213,Denmark,DNK,8.213,63.534,169,1815,Europe,10662,2002
1984,12646,8.213,Denmark,DNK,8.213,63.534,169,1815,Europe,10662,2002
1984,12646,8.213,Denmark,DNK,8.213,63.534,169,1815,Europe,10662,2002
1984,12646,8.213,Denmark,DNK,8.213,63.534,169,1815,Europe,10662,2002
1984,12646,8.213,Denmark,DNK,8.213,63.534,169,1815,Europe,10662,2002
1984,12646,8.213,Denmark,DNK,8.213,63.534,169,1815,Europe,10662,2002
2369,11303,6.025,Finland,FIN,6.025,84.959,207,2162,Europe,8934,2002
2369,11303,6.025,Finland,FIN,6.025,84.959,207,2162,Europe,8934,2002
2369,11303,6.025,Finland,FIN,6.025,84.959,207,2162,Europe,8934,2002
2369,11303,6.025,Finland,FIN,6.025,84.959,207,2162,Europe,8934,2002
2369,11303,6.025,Finland,FIN,6.025,84.959,207,2162,Europe,8934,2002
2369,11303,6.025,Finland,FIN,6.025,84.959,207,2162,Europe,8934,2002
2369,11303,6.025,Finland,FIN,6.025,84.959,207,2162,Europe,8934,2002
450,3932,7.405,Iceland,ISL,7.405,54.05,379,71,Europe,3482,2002
450,3932,7.405,Iceland,ISL,7.405,54.05,379,71,Europe,3482,2002
450,3932,7.405,Iceland,ISL,7.405,54.05,379,71,Europe,3482,2002
450,3932,7.405,Iceland,ISL,7.405,54.05,379,71,Europe,3482,2002
450,3932,7.405,Iceland,ISL,7.405,54.05,379,71,Europe,3482,2002
450,3932,7.405,Iceland,ISL,7.405,54.05,379,71,Europe,3482,2002
450,3932,7.405,Iceland,ISL,7.405,54.05,379,71,Europe,3482,2002
131,7273,8.6955,Lithuania,LTU,0,61.158,46,85,Europe,7142,2002
131,7273,8.6955,Lithuania,LTU,0,61.158,46,85,Europe,7142,2002
131,7273,8.6955,Lithuania,LTU,0,61.158,46,85,Europe,7142,2002
131,7273,8.6955,Lithuania,LTU,0,61.158,46,85,Europe,7142,2002
131,7273,8.6955,Lithuania,LTU,0,61.158,46,85,Europe,7142,2002
131,7273,8.6955,Lithuania,LTU,0,61.158,46,85,Europe,7142,2002
131,7273,8.6955,Lithuania,LTU,0,61.158,46,85,Europe,7142,2002
2603,2603,4.88,Netherlands,NLD,4.88,56.188,481,2122,Europe,0,2002
2603,2603,4.88,Netherlands,NLD,4.88,56.188,481,2122,Europe,0,2002
2603,2603,4.88,Netherlands,NLD,4.88,56.188,481,2122,Europe,0,2002
2603,2603,4.88,Netherlands,NLD,4.88,56.188,481,2122,Europe,0,2002
2603,2603,4.88,Netherlands,NLD,4.88,56.188,481,2122,Europe,0,2002
2603,2603,4.88,Netherlands,NLD,4.88,56.188,481,2122,Europe,0,2002
2603,2603,4.88,Netherlands,NLD,4.88,56.188,481,2122,Europe,0,2002
6287,19025,7.441,Norway,NOR,7.441,73.373,5109,1178,Europe,12738,2002
6287,19025,7.441,Norway,NOR,7.441,73.373,5109,1178,Europe,12738,2002
6287,19025,7.441,Norway,NOR,7.441,73.373,5109,1178,Europe,12738,2002
6287,19025,7.441,Norway,NOR,7.441,73.373,5109,1178,Europe,12738,2002
6287,19025,7.441,Norway,NOR,7.441,73.373,5109,1178,Europe,12738,2002
6287,19025,7.441,Norway,NOR,7.441,73.373,5109,1178,Europe,12738,2002
6287,19025,7.441,Norway,NOR,7.441,73.373,5109,1178,Europe,12738,2002
401,8099,5.655,Slovenia,SVN,5.655,66.299,101,300,Europe,7698,2002
401,8099,5.655,Slovenia,SVN,5.655,66.299,101,300,Europe,7698,2002
401,8099,5.655,Slovenia,SVN,5.655,66.299,101,300,Europe,7698,2002
401,8099,5.655,Slovenia,SVN,5.655,66.299,101,300,Europe,7698,2002
401,8099,5.655,Slovenia,SVN,5.655,66.299,101,300,Europe,7698,2002
401,8099,5.655,Slovenia,SVN,5.655,66.299,101,300,Europe,7698,2002
401,8099,5.655,Slovenia,SVN,5.655,66.299,101,300,Europe,7698,2002
3955,18280,7.001,Sweden,SWE,7.001,75.305,597,3358,Europe,14325,2002
3955,18280,7.001,Sweden,SWE,7.001,75.305,597,3358,Europe,14325,2002
3955,18280,7.001,Sweden,SWE,7.001,75.305,597,3358,Europe,14325,2002
3955,18280,7.001,Sweden,SWE,7.001,75.305,597,3358,Europe,14325,2002
3955,18280,7.001,Sweden,SWE,7.001,75.305,597,3358,Europe,14325,2002
3955,18280,7.001,Sweden,SWE,7.001,75.305,597,3358,Europe,14325,2002
3955,18280,7.001,Sweden,SWE,7.001,75.305,597,3358,Europe,14325,2002
2754,19361,5.433,Ukraine,UKR,5.433,56.432,1153,1601,Europe,16607,2002
2754,19361,5.433,Ukraine,UKR,5.433,56.432,1153,1601,Europe,16607,2002
2754,19361,5.433,Ukraine,UKR,5.433,56.432,1153,1601,Europe,16607,2002
2754,19361,5.433,Ukraine,UKR,5.433,56.432,1153,1601,Europe,16607,2002
2754,19361,5.433,Ukraine,UKR,5.433,56.432,1153,1601,Europe,16607,2002
2754,19361,5.433,Ukraine,UKR,5.433,56.432,1153,1601,Europe,16607,2002
2754,19361,5.433,Ukraine,UKR,5.433,56.432,1153,1601,Europe,16607,2002
31531,67525,4.976,United Kingdom,GBR,4.976,62.602,10907,20624,Europe,35994,2002
31531,67525,4.976,United Kingdom,GBR,4.976,62.602,10907,20624,Europe,35994,2002
31531,67525,4.976,United Kingdom,GBR,4.976,62.602,10907,20624,Europe,35994,2002
31531,67525,4.976,United Kingdom,GBR,4.976,62.602,10907,20624,Europe,35994,2002
31531,67525,4.976,United Kingdom,GBR,4.976,62.602,10907,20624,Europe,35994,2002
31531,67525,4.976,United Kingdom,GBR,4.976,62.602,10907,20624,Europe,35994,2002
31531,67525,4.976,United Kingdom,GBR,4.976,62.602,10907,20624,Europe,35994,2002
2333,19219,5.382,Austria,AUT,5.382,46.424,213,2120,Europe,16886,2003
2333,19219,5.382,Austria,AUT,5.382,46.424,213,2120,Europe,16886,2003
2333,19219,5.382,Austria,AUT,5.382,46.424,213,2120,Europe,16886,2003
2333,19219,5.382,Austria,AUT,5.382,46.424,213,2120,Europe,16886,2003
2333,19219,5.382,Austria,AUT,5.382,46.424,213,2120,Europe,16886,2003
2333,19219,5.382,Austria,AUT,5.382,46.424,213,2120,Europe,16886,2003
2333,19219,5.382,Austria,AUT,5.382,46.424,213,2120,Europe,16886,2003
707,32454,5.893,Belgium,BEL,5.893,59.865,188,519,Europe,31747,2003
707,32454,5.893,Belgium,BEL,5.893,59.865,188,519,Europe,31747,2003
707,32454,5.893,Belgium,BEL,5.893,59.865,188,519,Europe,31747,2003
707,32454,5.893,Belgium,BEL,5.893,59.865,188,519,Europe,31747,2003
707,32454,5.893,Belgium,BEL,5.893,59.865,188,519,Europe,31747,2003
707,32454,5.893,Belgium,BEL,5.893,59.865,188,519,Europe,31747,2003
707,32454,5.893,Belgium,BEL,5.893,59.865,188,519,Europe,31747,2003
1925,11965,8.122,Denmark,DNK,8.122,67.535,153,1772,Europe,10040,2003
1925,11965,8.122,Denmark,DNK,8.122,67.535,153,1772,Europe,10040,2003
1925,11965,8.122,Denmark,DNK,8.122,67.535,153,1772,Europe,10040,2003
1925,11965,8.122,Denmark,DNK,8.122,67.535,153,1772,Europe,10040,2003
1925,11965,8.122,Denmark,DNK,8.122,67.535,153,1772,Europe,10040,2003
1925,11965,8.122,Denmark,DNK,8.122,67.535,153,1772,Europe,10040,2003
1925,11965,8.122,Denmark,DNK,8.122,67.535,153,1772,Europe,10040,2003
2187,10176,6.175,Finland,FIN,6.175,87.077,215,1972,Europe,7989,2003
2187,10176,6.175,Finland,FIN,6.175,87.077,215,1972,Europe,7989,2003
2187,10176,6.175,Finland,FIN,6.175,87.077,215,1972,Europe,7989,2003
2187,10176,6.175,Finland,FIN,6.175,87.077,215,1972,Europe,7989,2003
2187,10176,6.175,Finland,FIN,6.175,87.077,215,1972,Europe,7989,2003
2187,10176,6.175,Finland,FIN,6.175,87.077,215,1972,Europe,7989,2003
2187,10176,6.175,Finland,FIN,6.175,87.077,215,1972,Europe,7989,2003
805,4111,7.312,Iceland,ISL,7.312,62.175,748,57,Europe,3306,2003
805,4111,7.312,Iceland,ISL,7.312,62.175,748,57,Europe,3306,2003
805,4111,7.312,Iceland,ISL,7.312,62.175,748,57,Europe,3306,2003
805,4111,7.312,Iceland,ISL,7.312,62.175,748,57,Europe,3306,2003
805,4111,7.312,Iceland,ISL,7.312,62.175,748,57,Europe,3306,2003
805,4111,7.312,Iceland,ISL,7.312,62.175,748,57,Europe,3306,2003
805,4111,7.312,Iceland,ISL,7.312,62.175,748,57,Europe,3306,2003
113,8678,8.6955,Lithuania,LTU,0,68.866,49,64,Europe,8565,2003
113,8678,8.6955,Lithuania,LTU,0,68.866,49,64,Europe,8565,2003
113,8678,8.6955,Lithuania,LTU,0,68.866,49,64,Europe,8565,2003
113,8678,8.6955,Lithuania,LTU,0,68.866,49,64,Europe,8565,2003
113,8678,8.6955,Lithuania,LTU,0,68.866,49,64,Europe,8565,2003
113,8678,8.6955,Lithuania,LTU,0,68.866,49,64,Europe,8565,2003
113,8678,8.6955,Lithuania,LTU,0,68.866,49,64,Europe,8565,2003
2861,2861,5.11,Netherlands,NLD,5.11,56.795,573,2288,Europe,0,2003
2861,2861,5.11,Netherlands,NLD,5.11,56.795,573,2288,Europe,0,2003
2861,2861,5.11,Netherlands,NLD,5.11,56.795,573,2288,Europe,0,2003
2861,2861,5.11,Netherlands,NLD,5.11,56.795,573,2288,Europe,0,2003
2861,2861,5.11,Netherlands,NLD,5.11,56.795,573,2288,Europe,0,2003
2861,2861,5.11,Netherlands,NLD,5.11,56.795,573,2288,Europe,0,2003
2861,2861,5.11,Netherlands,NLD,5.11,56.795,573,2288,Europe,0,2003
5861,18049,7.42,Norway,NOR,7.42,79.108,4782,1079,Europe,12188,2003
5861,18049,7.42,Norway,NOR,7.42,79.108,4782,1079,Europe,12188,2003
5861,18049,7.42,Norway,NOR,7.42,79.108,4782,1079,Europe,12188,2003
5861,18049,7.42,Norway,NOR,7.42,79.108,4782,1079,Europe,12188,2003
5861,18049,7.42,Norway,NOR,7.42,79.108,4782,1079,Europe,12188,2003
5861,18049,7.42,Norway,NOR,7.42,79.108,4782,1079,Europe,12188,2003
5861,18049,7.42,Norway,NOR,7.42,79.108,4782,1079,Europe,12188,2003
370,8731,5.691,Slovenia,SVN,5.691,69.011,60,310,Europe,8361,2003
370,8731,5.691,Slovenia,SVN,5.691,69.011,60,310,Europe,8361,2003
370,8731,5.691,Slovenia,SVN,5.691,69.011,60,310,Europe,8361,2003
370,8731,5.691,Slovenia,SVN,5.691,69.011,60,310,Europe,8361,2003
370,8731,5.691,Slovenia,SVN,5.691,69.011,60,310,Europe,8361,2003
370,8731,5.691,Slovenia,SVN,5.691,69.011,60,310,Europe,8361,2003
370,8731,5.691,Slovenia,SVN,5.691,69.011,60,310,Europe,8361,2003
3728,17054,6.858,Sweden,SWE,6.858,81.439,703,3025,Europe,13326,2003
3728,17054,6.858,Sweden,SWE,6.858,81.439,703,3025,Europe,13326,2003
3728,17054,6.858,Sweden,SWE,6.858,81.439,703,3025,Europe,13326,2003
3728,17054,6.858,Sweden,SWE,6.858,81.439,703,3025,Europe,13326,2003
3728,17054,6.858,Sweden,SWE,6.858,81.439,703,3025,Europe,13326,2003
3728,17054,6.858,Sweden,SWE,6.858,81.439,703,3025,Europe,13326,2003
3728,17054,6.858,Sweden,SWE,6.858,81.439,703,3025,Europe,13326,2003
3073,23121,5.602,Ukraine,UKR,5.602,60.845,1438,1635,Europe,20048,2003
3073,23121,5.602,Ukraine,UKR,5.602,60.845,1438,1635,Europe,20048,2003
3073,23121,5.602,Ukraine,UKR,5.602,60.845,1438,1635,Europe,20048,2003
3073,23121,5.602,Ukraine,UKR,5.602,60.845,1438,1635,Europe,20048,2003
3073,23121,5.602,Ukraine,UKR,5.602,60.845,1438,1635,Europe,20048,2003
3073,23121,5.602,Ukraine,UKR,5.602,60.845,1438,1635,Europe,20048,2003
3073,23121,5.602,Ukraine,UKR,5.602,60.845,1438,1635,Europe,20048,2003
31624,66075,5.12,United Kingdom,GBR,5.12,62.086,11198,20426,Europe,34451,2003
31624,66075,5.12,United Kingdom,GBR,5.12,62.086,11198,20426,Europe,34451,2003
31624,66075,5.12,United Kingdom,GBR,5.12,62.086,11198,20426,Europe,34451,2003
31624,66075,5.12,United Kingdom,GBR,5.12,62.086,11198,20426,Europe,34451,2003
31624,66075,5.12,United Kingdom,GBR,5.12,62.086,11198,20426,Europe,34451,2003
31624,66075,5.12,United Kingdom,GBR,5.12,62.086,11198,20426,Europe,34451,2003
31624,66075,5.12,United Kingdom,GBR,5.12,62.086,11198,20426,Europe,34451,2003
2514,18392,5.321,Austria,AUT,5.321,47.2,266,2248,Europe,15878,2004
2514,18392,5.321,Austria,AUT,5.321,47.2,266,2248,Europe,15878,2004
2514,18392,5.321,Austria,AUT,5.321,47.2,266,2248,Europe,15878,2004
2514,18392,5.321,Austria,AUT,5.321,47.2,266,2248,Europe,15878,2004
2514,18392,5.321,Austria,AUT,5.321,47.2,266,2248,Europe,15878,2004
2514,18392,5.321,Austria,AUT,5.321,47.2,266,2248,Europe,15878,2004
2514,18392,5.321,Austria,AUT,5.321,47.2,266,2248,Europe,15878,2004
636,30957,5.814,Belgium,BEL,5.814,61.248,122,514,Europe,30321,2004
636,30957,5.814,Belgium,BEL,5.814,61.248,122,514,Europe,30321,2004
636,30957,5.814,Belgium,BEL,5.814,61.248,122,514,Europe,30321,2004
636,30957,5.814,Belgium,BEL,5.814,61.248,122,514,Europe,30321,2004
636,30957,5.814,Belgium,BEL,5.814,61.248,122,514,Europe,30321,2004
636,30957,5.814,Belgium,BEL,5.814,61.248,122,514,Europe,30321,2004
636,30957,5.814,Belgium,BEL,5.814,61.248,122,514,Europe,30321,2004
2015,12072,8.212,Denmark,DNK,8.212,74.437,138,1877,Europe,10057,2004
2015,12072,8.212,Denmark,DNK,8.212,74.437,138,1877,Europe,10057,2004
2015,12072,8.212,Denmark,DNK,8.212,74.437,138,1877,Europe,10057,2004
2015,12072,8.212,Denmark,DNK,8.212,74.437,138,1877,Europe,10057,2004
2015,12072,8.212,Denmark,DNK,8.212,74.437,138,1877,Europe,10057,2004
2015,12072,8.212,Denmark,DNK,8.212,74.437,138,1877,Europe,10057,2004
2015,12072,8.212,Denmark,DNK,8.212,74.437,138,1877,Europe,10057,2004
2220,10021,6.169,Finland,FIN,6.169,89.664,209,2011,Europe,7801,2004
2220,10021,6.169,Finland,FIN,6.169,89.664,209,2011,Europe,7801,2004
2220,10021,6.169,Finland,FIN,6.169,89.664,209,2011,Europe,7801,2004
2220,10021,6.169,Finland,FIN,6.169,89.664,209,2011,Europe,7801,2004
2220,10021,6.169,Finland,FIN,6.169,89.664,209,2011,Europe,7801,2004
2220,10021,6.169,Finland,FIN,6.169,89.664,209,2011,Europe,7801,2004
2220,10021,6.169,Finland,FIN,6.169,89.664,209,2011,Europe,7801,2004
529,4002,7.207,Iceland,ISL,7.207,68.412,463,66,Europe,3473,2004
529,4002,7.207,Iceland,ISL,7.207,68.412,463,66,Europe,3473,2004
529,4002,7.207,Iceland,ISL,7.207,68.412,463,66,Europe,3473,2004
529,4002,7.207,Iceland,ISL,7.207,68.412,463,66,Europe,3473,2004
529,4002,7.207,Iceland,ISL,7.207,68.412,463,66,Europe,3473,2004
529,4002,7.207,Iceland,ISL,7.207,68.412,463,66,Europe,3473,2004
529,4002,7.207,Iceland,ISL,7.207,68.412,463,66,Europe,3473,2004
114,7363,17.848,Lithuania,LTU,17.848,75.031,44,70,Europe,7249,2004
114,7363,17.848,Lithuania,LTU,17.848,75.031,44,70,Europe,7249,2004
114,7363,17.848,Lithuania,LTU,17.848,75.031,44,70,Europe,7249,2004
114,7363,17.848,Lithuania,LTU,17.848,75.031,44,70,Europe,7249,2004
114,7363,17.848,Lithuania,LTU,17.848,75.031,44,70,Europe,7249,2004
114,7363,17.848,Lithuania,LTU,17.848,75.031,44,70,Europe,7249,2004
114,7363,17.848,Lithuania,LTU,17.848,75.031,44,70,Europe,7249,2004
2743,2743,5.15,Netherlands,NLD,5.15,58.053,556,2187,Europe,0,2004
2743,2743,5.15,Netherlands,NLD,5.15,58.053,556,2187,Europe,0,2004
2743,2743,5.15,Netherlands,NLD,5.15,58.053,556,2187,Europe,0,2004
2743,2743,5.15,Netherlands,NLD,5.15,58.053,556,2187,Europe,0,2004
2743,2743,5.15,Netherlands,NLD,5.15,58.053,556,2187,Europe,0,2004
2743,2743,5.15,Netherlands,NLD,5.15,58.053,556,2187,Europe,0,2004
2743,2743,5.15,Netherlands,NLD,5.15,58.053,556,2187,Europe,0,2004
5490,18043,7.303,Norway,NOR,7.303,79.264,4348,1142,Europe,12553,2004
5490,18043,7.303,Norway,NOR,7.303,79.264,4348,1142,Europe,12553,2004
5490,18043,7.303,Norway,NOR,7.303,79.264,4348,1142,Europe,12553,2004
5490,18043,7.303,Norway,NOR,7.303,79.264,4348,1142,Europe,12553,2004
5490,18043,7.303,Norway,NOR,7.303,79.264,4348,1142,Europe,12553,2004
5490,18043,7.303,Norway,NOR,7.303,79.264,4348,1142,Europe,12553,2004
5490,18043,7.303,Norway,NOR,7.303,79.264,4348,1142,Europe,12553,2004
384,7815,5.635,Slovenia,SVN,5.635,72.407,42,342,Europe,7431,2004
384,7815,5.635,Slovenia,SVN,5.635,72.407,42,342,Europe,7431,2004
384,7815,5.635,Slovenia,SVN,5.635,72.407,42,342,Europe,7431,2004
384,7815,5.635,Slovenia,SVN,5.635,72.407,42,342,Europe,7431,2004
384,7815,5.635,Slovenia,SVN,5.635,72.407,42,342,Europe,7431,2004
384,7815,5.635,Slovenia,SVN,5.635,72.407,42,342,Europe,7431,2004
384,7815,5.635,Slovenia,SVN,5.635,72.407,42,342,Europe,7431,2004
3230,17030,6.723,Sweden,SWE,6.723,83.78,462,2768,Europe,13800,2004
3230,17030,6.723,Sweden,SWE,6.723,83.78,462,2768,Europe,13800,2004
3230,17030,6.723,Sweden,SWE,6.723,83.78,462,2768,Europe,13800,2004
3230,17030,6.723,Sweden,SWE,6.723,83.78,462,2768,Europe,13800,2004
3230,17030,6.723,Sweden,SWE,6.723,83.78,462,2768,Europe,13800,2004
3230,17030,6.723,Sweden,SWE,6.723,83.78,462,2768,Europe,13800,2004
3230,17030,6.723,Sweden,SWE,6.723,83.78,462,2768,Europe,13800,2004
5779,26109,5.308,Ukraine,UKR,5.308,66.002,1689,4090,Europe,20330,2004
5779,26109,5.308,Ukraine,UKR,5.308,66.002,1689,4090,Europe,20330,2004
5779,26109,5.308,Ukraine,UKR,5.308,66.002,1689,4090,Europe,20330,2004
5779,26109,5.308,Ukraine,UKR,5.308,66.002,1689,4090,Europe,20330,2004
5779,26109,5.308,Ukraine,UKR,5.308,66.002,1689,4090,Europe,20330,2004
5779,26109,5.308,Ukraine,UKR,5.308,66.002,1689,4090,Europe,20330,2004
5779,26109,5.308,Ukraine,UKR,5.308,66.002,1689,4090,Europe,20330,2004
29954,65518,5.005,United Kingdom,GBR,5.005,59.363,10776,19178,Europe,35564,2004
29954,65518,5.005,United Kingdom,GBR,5.005,59.363,10776,19178,Europe,35564,2004
29954,65518,5.005,United Kingdom,GBR,5.005,59.363,10776,19178,Europe,35564,2004
29954,65518,5.005,United Kingdom,GBR,5.005,59.363,10776,19178,Europe,35564,2004
29954,65518,5.005,United Kingdom,GBR,5.005,59.363,10776,19178,Europe,35564,2004
29954,65518,5.005,United Kingdom,GBR,5.005,59.363,10776,19178,Europe,35564,2004
29954,65518,5.005,United Kingdom,GBR,5.005,59.363,10776,19178,Europe,35564,2004
2505,18737,5.271,Austria,AUT,5.271,47.782,235,2270,Europe,16232,2005
2505,18737,5.271,Austria,AUT,5.271,47.782,235,2270,Europe,16232,2005
2505,18737,5.271,Austria,AUT,5.271,47.782,235,2270,Europe,16232,2005
2505,18737,5.271,Austria,AUT,5.271,47.782,235,2270,Europe,16232,2005
2505,18737,5.271,Austria,AUT,5.271,47.782,235,2270,Europe,16232,2005
2505,18737,5.271,Austria,AUT,5.271,47.782,235,2270,Europe,16232,2005
2505,18737,5.271,Austria,AUT,5.271,47.782,235,2270,Europe,16232,2005
622,39222,5.775,Belgium,BEL,5.775,61.404,105,517,Europe,38600,2005
622,39222,5.775,Belgium,BEL,5.775,61.404,105,517,Europe,38600,2005
622,39222,5.775,Belgium,BEL,5.775,61.404,105,517,Europe,38600,2005
622,39222,5.775,Belgium,BEL,5.775,61.404,105,517,Europe,38600,2005
622,39222,5.775,Belgium,BEL,5.775,61.404,105,517,Europe,38600,2005
622,39222,5.775,Belgium,BEL,5.775,61.404,105,517,Europe,38600,2005
622,39222,5.775,Belgium,BEL,5.775,61.404,105,517,Europe,38600,2005
1823,12423,8.083,Denmark,DNK,8.083,80.423,165,1658,Europe,10600,2005
1823,12423,8.083,Denmark,DNK,8.083,80.423,165,1658,Europe,10600,2005
1823,12423,8.083,Denmark,DNK,8.083,80.423,165,1658,Europe,10600,2005
1823,12423,8.083,Denmark,DNK,8.083,80.423,165,1658,Europe,10600,2005
1823,12423,8.083,Denmark,DNK,8.083,80.423,165,1658,Europe,10600,2005
1823,12423,8.083,Denmark,DNK,8.083,80.423,165,1658,Europe,10600,2005
1823,12423,8.083,Denmark,DNK,8.083,80.423,165,1658,Europe,10600,2005
2059,9795,6.036,Finland,FIN,6.036,91.829,229,1830,Europe,7736,2005
2059,9795,6.036,Finland,FIN,6.036,91.829,229,1830,Europe,7736,2005
2059,9795,6.036,Finland,FIN,6.036,91.829,229,1830,Europe,7736,2005
2059,9795,6.036,Finland,FIN,6.036,91.829,229,1830,Europe,7736,2005
2059,9795,6.036,Finland,FIN,6.036,91.829,229,1830,Europe,7736,2005
2059,9795,6.036,Finland,FIN,6.036,91.829,229,1830,Europe,7736,2005
2059,9795,6.036,Finland,FIN,6.036,91.829,229,1830,Europe,7736,2005
592,4776,7.362,Iceland,ISL,7.362,70.377,545,47,Europe,4184,2005
592,4776,7.362,Iceland,ISL,7.362,70.377,545,47,Europe,4184,2005
592,4776,7.362,Iceland,ISL,7.362,70.377,545,47,Europe,4184,2005
592,4776,7.362,Iceland,ISL,7.362,70.377,545,47,Europe,4184,2005
592,4776,7.362,Iceland,ISL,7.362,70.377,545,47,Europe,4184,2005
592,4776,7.362,Iceland,ISL,7.362,70.377,545,47,Europe,4184,2005
592,4776,7.362,Iceland,ISL,7.362,70.377,545,47,Europe,4184,2005
115,6417,16.826,Lithuania,LTU,16.826,80.371,47,68,Europe,6302,2005
115,6417,16.826,Lithuania,LTU,16.826,80.371,47,68,Europe,6302,2005
115,6417,16.826,Lithuania,LTU,16.826,80.371,47,68,Europe,6302,2005
115,6417,16.826,Lithuania,LTU,16.826,80.371,47,68,Europe,6302,2005
115,6417,16.826,Lithuania,LTU,16.826,80.371,47,68,Europe,6302,2005
115,6417,16.826,Lithuania,LTU,16.826,80.371,47,68,Europe,6302,2005
115,6417,16.826,Lithuania,LTU,16.826,80.371,47,68,Europe,6302,2005
2850,2850,5.206,Netherlands,NLD,5.206,59.752,633,2217,Europe,0,2005
2850,2850,5.206,Netherlands,NLD,5.206,59.752,633,2217,Europe,0,2005
2850,2850,5.206,Netherlands,NLD,5.206,59.752,633,2217,Europe,0,2005
2850,2850,5.206,Netherlands,NLD,5.206,59.752,633,2217,Europe,0,2005
2850,2850,5.206,Netherlands,NLD,5.206,59.752,633,2217,Europe,0,2005
2850,2850,5.206,Netherlands,NLD,5.206,59.752,633,2217,Europe,0,2005
2850,2850,5.206,Netherlands,NLD,5.206,59.752,633,2217,Europe,0,2005
5986,20536,6.869,Norway,NOR,6.869,78.551,4843,1143,Europe,14550,2005
5986,20536,6.869,Norway,NOR,6.869,78.551,4843,1143,Europe,14550,2005
5986,20536,6.869,Norway,NOR,6.869,78.551,4843,1143,Europe,14550,2005
5986,20536,6.869,Norway,NOR,6.869,78.551,4843,1143,Europe,14550,2005
5986,20536,6.869,Norway,NOR,6.869,78.551,4843,1143,Europe,14550,2005
5986,20536,6.869,Norway,NOR,6.869,78.551,4843,1143,Europe,14550,2005
5986,20536,6.869,Norway,NOR,6.869,78.551,4843,1143,Europe,14550,2005
373,6843,5.582,Slovenia,SVN,5.582,79.283,29,344,Europe,6470,2005
373,6843,5.582,Slovenia,SVN,5.582,79.283,29,344,Europe,6470,2005
373,6843,5.582,Slovenia,SVN,5.582,79.283,29,344,Europe,6470,2005
373,6843,5.582,Slovenia,SVN,5.582,79.283,29,344,Europe,6470,2005
373,6843,5.582,Slovenia,SVN,5.582,79.283,29,344,Europe,6470,2005
373,6843,5.582,Slovenia,SVN,5.582,79.283,29,344,Europe,6470,2005
373,6843,5.582,Slovenia,SVN,5.582,79.283,29,344,Europe,6470,2005
2960,17772,6.56,Sweden,SWE,6.56,81.975,438,2522,Europe,14812,2005
2960,17772,6.56,Sweden,SWE,6.56,81.975,438,2522,Europe,14812,2005
2960,17772,6.56,Sweden,SWE,6.56,81.975,438,2522,Europe,14812,2005
2960,17772,6.56,Sweden,SWE,6.56,81.975,438,2522,Europe,14812,2005
2960,17772,6.56,Sweden,SWE,6.56,81.975,438,2522,Europe,14812,2005
2960,17772,6.56,Sweden,SWE,6.56,81.975,438,2522,Europe,14812,2005
2960,17772,6.56,Sweden,SWE,6.56,81.975,438,2522,Europe,14812,2005
5592,30245,6.058,Ukraine,UKR,6.058,71.112,2054,3538,Europe,24653,2005
5592,30245,6.058,Ukraine,UKR,6.058,71.112,2054,3538,Europe,24653,2005
5592,30245,6.058,Ukraine,UKR,6.058,71.112,2054,3538,Europe,24653,2005
5592,30245,6.058,Ukraine,UKR,6.058,71.112,2054,3538,Europe,24653,2005
5592,30245,6.058,Ukraine,UKR,6.058,71.112,2054,3538,Europe,24653,2005
5592,30245,6.058,Ukraine,UKR,6.058,71.112,2054,3538,Europe,24653,2005
5592,30245,6.058,Ukraine,UKR,6.058,71.112,2054,3538,Europe,24653,2005
27988,64986,5.195,United Kingdom,GBR,5.195,59.001,10155,17833,Europe,36998,2005
27988,64986,5.195,United Kingdom,GBR,5.195,59.001,10155,17833,Europe,36998,2005
27988,64986,5.195,United Kingdom,GBR,5.195,59.001,10155,17833,Europe,36998,2005
27988,64986,5.195,United Kingdom,GBR,5.195,59.001,10155,17833,Europe,36998,2005
27988,64986,5.195,United Kingdom,GBR,5.195,59.001,10155,17833,Europe,36998,2005
27988,64986,5.195,United Kingdom,GBR,5.195,59.001,10155,17833,Europe,36998,2005
27988,64986,5.195,United Kingdom,GBR,5.195,59.001,10155,17833,Europe,36998,2005
2649,17841,5.253,Austria,AUT,5.253,49.413,378,2271,Europe,15192,2006
2649,17841,5.253,Austria,AUT,5.253,49.413,378,2271,Europe,15192,2006
2649,17841,5.253,Austria,AUT,5.253,49.413,378,2271,Europe,15192,2006
2649,17841,5.253,Austria,AUT,5.253,49.413,378,2271,Europe,15192,2006
2649,17841,5.253,Austria,AUT,5.253,49.413,378,2271,Europe,15192,2006
2649,17841,5.253,Austria,AUT,5.253,49.413,378,2271,Europe,15192,2006
2649,17841,5.253,Austria,AUT,5.253,49.413,378,2271,Europe,15192,2006
651,34626,5.828,Belgium,BEL,5.828,61.959,161,490,Europe,33975,2006
651,34626,5.828,Belgium,BEL,5.828,61.959,161,490,Europe,33975,2006
651,34626,5.828,Belgium,BEL,5.828,61.959,161,490,Europe,33975,2006
651,34626,5.828,Belgium,BEL,5.828,61.959,161,490,Europe,33975,2006
651,34626,5.828,Belgium,BEL,5.828,61.959,161,490,Europe,33975,2006
651,34626,5.828,Belgium,BEL,5.828,61.959,161,490,Europe,33975,2006
651,34626,5.828,Belgium,BEL,5.828,61.959,161,490,Europe,33975,2006
1691,10917,7.728,Denmark,DNK,7.728,79.065,188,1503,Europe,9226,2006
1691,10917,7.728,Denmark,DNK,7.728,79.065,188,1503,Europe,9226,2006
1691,10917,7.728,Denmark,DNK,7.728,79.065,188,1503,Europe,9226,2006
1691,10917,7.728,Denmark,DNK,7.728,79.065,188,1503,Europe,9226,2006
1691,10917,7.728,Denmark,DNK,7.728,79.065,188,1503,Europe,9226,2006
1691,10917,7.728,Denmark,DNK,7.728,79.065,188,1503,Europe,9226,2006
1691,10917,7.728,Denmark,DNK,7.728,79.065,188,1503,Europe,9226,2006
2018,9551,5.938,Finland,FIN,5.938,93.288,202,1816,Europe,7533,2006
2018,9551,5.938,Finland,FIN,5.938,93.288,202,1816,Europe,7533,2006
2018,9551,5.938,Finland,FIN,5.938,93.288,202,1816,Europe,7533,2006
2018,9551,5.938,Finland,FIN,5.938,93.288,202,1816,Europe,7533,2006
2018,9551,5.938,Finland,FIN,5.938,93.288,202,1816,Europe,7533,2006
2018,9551,5.938,Finland,FIN,5.938,93.288,202,1816,Europe,7533,2006
2018,9551,5.938,Finland,FIN,5.938,93.288,202,1816,Europe,7533,2006
371,5099,7.348,Iceland,ISL,7.348,72.665,326,45,Europe,4728,2006
371,5099,7.348,Iceland,ISL,7.348,72.665,326,45,Europe,4728,2006
371,5099,7.348,Iceland,ISL,7.348,72.665,326,45,Europe,4728,2006
371,5099,7.348,Iceland,ISL,7.348,72.665,326,45,Europe,4728,2006
371,5099,7.348,Iceland,ISL,7.348,72.665,326,45,Europe,4728,2006
371,5099,7.348,Iceland,ISL,7.348,72.665,326,45,Europe,4728,2006
371,5099,7.348,Iceland,ISL,7.348,72.665,326,45,Europe,4728,2006
99,6468,16.644,Lithuania,LTU,16.644,81.865,34,65,Europe,6369,2006
99,6468,16.644,Lithuania,LTU,16.644,81.865,34,65,Europe,6369,2006
99,6468,16.644,Lithuania,LTU,16.644,81.865,34,65,Europe,6369,2006
99,6468,16.644,Lithuania,LTU,16.644,81.865,34,65,Europe,6369,2006
99,6468,16.644,Lithuania,LTU,16.644,81.865,34,65,Europe,6369,2006
99,6468,16.644,Lithuania,LTU,16.644,81.865,34,65,Europe,6369,2006
99,6468,16.644,Lithuania,LTU,16.644,81.865,34,65,Europe,6369,2006
2716,2716,5.142,Netherlands,NLD,5.142,60.639,548,2168,Europe,0,2006
2716,2716,5.142,Netherlands,NLD,5.142,60.639,548,2168,Europe,0,2006
2716,2716,5.142,Netherlands,NLD,5.142,60.639,548,2168,Europe,0,2006
2716,2716,5.142,Netherlands,NLD,5.142,60.639,548,2168,Europe,0,2006
2716,2716,5.142,Netherlands,NLD,5.142,60.639,548,2168,Europe,0,2006
2716,2716,5.142,Netherlands,NLD,5.142,60.639,548,2168,Europe,0,2006
2716,2716,5.142,Netherlands,NLD,5.142,60.639,548,2168,Europe,0,2006
6076,21430,6.386,Norway,NOR,6.386,77.684,4957,1119,Europe,15354,2006
6076,21430,6.386,Norway,NOR,6.386,77.684,4957,1119,Europe,15354,2006
6076,21430,6.386,Norway,NOR,6.386,77.684,4957,1119,Europe,15354,2006
6076,21430,6.386,Norway,NOR,6.386,77.684,4957,1119,Europe,15354,2006
6076,21430,6.386,Norway,NOR,6.386,77.684,4957,1119,Europe,15354,2006
6076,21430,6.386,Norway,NOR,6.386,77.684,4957,1119,Europe,15354,2006
6076,21430,6.386,Norway,NOR,6.386,77.684,4957,1119,Europe,15354,2006
299,6195,5.576,Slovenia,SVN,5.576,82.571,12,287,Europe,5896,2006
299,6195,5.576,Slovenia,SVN,5.576,82.571,12,287,Europe,5896,2006
299,6195,5.576,Slovenia,SVN,5.576,82.571,12,287,Europe,5896,2006
299,6195,5.576,Slovenia,SVN,5.576,82.571,12,287,Europe,5896,2006
299,6195,5.576,Slovenia,SVN,5.576,82.571,12,287,Europe,5896,2006
299,6195,5.576,Slovenia,SVN,5.576,82.571,12,287,Europe,5896,2006
299,6195,5.576,Slovenia,SVN,5.576,82.571,12,287,Europe,5896,2006
2859,17128,6.411,Sweden,SWE,6.411,79.347,413,2446,Europe,14269,2006
2859,17128,6.411,Sweden,SWE,6.411,79.347,413,2446,Europe,14269,2006
2859,17128,6.411,Sweden,SWE,6.411,79.347,413,2446,Europe,14269,2006
2859,17128,6.411,Sweden,SWE,6.411,79.347,413,2446,Europe,14269,2006
2859,17128,6.411,Sweden,SWE,6.411,79.347,413,2446,Europe,14269,2006
2859,17128,6.411,Sweden,SWE,6.411,79.347,413,2446,Europe,14269,2006
2859,17128,6.411,Sweden,SWE,6.411,79.347,413,2446,Europe,14269,2006
5890,35775,6.209,Ukraine,UKR,6.209,76.855,2416,3474,Europe,29885,2006
5890,35775,6.209,Ukraine,UKR,6.209,76.855,2416,3474,Europe,29885,2006
5890,35775,6.209,Ukraine,UKR,6.209,76.855,2416,3474,Europe,29885,2006
5890,35775,6.209,Ukraine,UKR,6.209,76.855,2416,3474,Europe,29885,2006
5890,35775,6.209,Ukraine,UKR,6.209,76.855,2416,3474,Europe,29885,2006
5890,35775,6.209,Ukraine,UKR,6.209,76.855,2416,3474,Europe,29885,2006
5890,35775,6.209,Ukraine,UKR,6.209,76.855,2416,3474,Europe,29885,2006
25745,64856,5.247,United Kingdom,GBR,5.247,59.127,8261,17484,Europe,39111,2006
25745,64856,5.247,United Kingdom,GBR,5.247,59.127,8261,17484,Europe,39111,2006
25745,64856,5.247,United Kingdom,GBR,5.247,59.127,8261,17484,Europe,39111,2006
25745,64856,5.247,United Kingdom,GBR,5.247,59.127,8261,17484,Europe,39111,2006
25745,64856,5.247,United Kingdom,GBR,5.247,59.127,8261,17484,Europe,39111,2006
25745,64856,5.247,United Kingdom,GBR,5.247,59.127,8261,17484,Europe,39111,2006
25745,64856,5.247,United Kingdom,GBR,5.247,59.127,8261,17484,Europe,39111,2006
2672,17268,5.177,Austria,AUT,5.177,51.229,287,2385,Europe,14596,2007
2672,17268,5.177,Austria,AUT,5.177,51.229,287,2385,Europe,14596,2007
2672,17268,5.177,Austria,AUT,5.177,51.229,287,2385,Europe,14596,2007
2672,17268,5.177,Austria,AUT,5.177,51.229,287,2385,Europe,14596,2007
2672,17268,5.177,Austria,AUT,5.177,51.229,287,2385,Europe,14596,2007
2672,17268,5.177,Austria,AUT,5.177,51.229,287,2385,Europe,14596,2007
2672,17268,5.177,Austria,AUT,5.177,51.229,287,2385,Europe,14596,2007
617,31241,5.843,Belgium,BEL,5.843,61.35,163,454,Europe,30624,2007
617,31241,5.843,Belgium,BEL,5.843,61.35,163,454,Europe,30624,2007
617,31241,5.843,Belgium,BEL,5.843,61.35,163,454,Europe,30624,2007
617,31241,5.843,Belgium,BEL,5.843,61.35,163,454,Europe,30624,2007
617,31241,5.843,Belgium,BEL,5.843,61.35,163,454,Europe,30624,2007
617,31241,5.843,Belgium,BEL,5.843,61.35,163,454,Europe,30624,2007
617,31241,5.843,Belgium,BEL,5.843,61.35,163,454,Europe,30624,2007
1857,10440,7.614,Denmark,DNK,7.614,78.585,197,1660,Europe,8583,2007
1857,10440,7.614,Denmark,DNK,7.614,78.585,197,1660,Europe,8583,2007
1857,10440,7.614,Denmark,DNK,7.614,78.585,197,1660,Europe,8583,2007
1857,10440,7.614,Denmark,DNK,7.614,78.585,197,1660,Europe,8583,2007
1857,10440,7.614,Denmark,DNK,7.614,78.585,197,1660,Europe,8583,2007
1857,10440,7.614,Denmark,DNK,7.614,78.585,197,1660,Europe,8583,2007
1857,10440,7.614,Denmark,DNK,7.614,78.585,197,1660,Europe,8583,2007
2015,9415,5.686,Finland,FIN,5.686,93.978,211,1804,Europe,7400,2007
2015,9415,5.686,Finland,FIN,5.686,93.978,211,1804,Europe,7400,2007
2015,9415,5.686,Finland,FIN,5.686,93.978,211,1804,Europe,7400,2007
2015,9415,5.686,Finland,FIN,5.686,93.978,211,1804,Europe,7400,2007
2015,9415,5.686,Finland,FIN,5.686,93.978,211,1804,Europe,7400,2007
2015,9415,5.686,Finland,FIN,5.686,93.978,211,1804,Europe,7400,2007
2015,9415,5.686,Finland,FIN,5.686,93.978,211,1804,Europe,7400,2007
114,4790,7.011,Iceland,ISL,7.011,71.721,53,61,Europe,4676,2007
114,4790,7.011,Iceland,ISL,7.011,71.721,53,61,Europe,4676,2007
114,4790,7.011,Iceland,ISL,7.011,71.721,53,61,Europe,4676,2007
114,4790,7.011,Iceland,ISL,7.011,71.721,53,61,Europe,4676,2007
114,4790,7.011,Iceland,ISL,7.011,71.721,53,61,Europe,4676,2007
114,4790,7.011,Iceland,ISL,7.011,71.721,53,61,Europe,4676,2007
114,4790,7.011,Iceland,ISL,7.011,71.721,53,61,Europe,4676,2007
82,6522,15.85,Lithuania,LTU,15.85,82.568,20,62,Europe,6440,2007
82,6522,15.85,Lithuania,LTU,15.85,82.568,20,62,Europe,6440,2007
82,6522,15.85,Lithuania,LTU,15.85,82.568,20,62,Europe,6440,2007
82,6522,15.85,Lithuania,LTU,15.85,82.568,20,62,Europe,6440,2007
82,6522,15.85,Lithuania,LTU,15.85,82.568,20,62,Europe,6440,2007
82,6522,15.85,Lithuania,LTU,15.85,82.568,20,62,Europe,6440,2007
82,6522,15.85,Lithuania,LTU,15.85,82.568,20,62,Europe,6440,2007
2446,2446,4.971,Netherlands,NLD,4.971,60.946,367,2079,Europe,0,2007
2446,2446,4.971,Netherlands,NLD,4.971,60.946,367,2079,Europe,0,2007
2446,2446,4.971,Netherlands,NLD,4.971,60.946,367,2079,Europe,0,2007
2446,2446,4.971,Netherlands,NLD,4.971,60.946,367,2079,Europe,0,2007
2446,2446,4.971,Netherlands,NLD,4.971,60.946,367,2079,Europe,0,2007
2446,2446,4.971,Netherlands,NLD,4.971,60.946,367,2079,Europe,0,2007
2446,2446,4.971,Netherlands,NLD,4.971,60.946,367,2079,Europe,0,2007
6656,22632,6.535,Norway,NOR,6.535,75.41,5431,1225,Europe,15976,2007
6656,22632,6.535,Norway,NOR,6.535,75.41,5431,1225,Europe,15976,2007
6656,22632,6.535,Norway,NOR,6.535,75.41,5431,1225,Europe,15976,2007
6656,22632,6.535,Norway,NOR,6.535,75.41,5431,1225,Europe,15976,2007
6656,22632,6.535,Norway,NOR,6.535,75.41,5431,1225,Europe,15976,2007
6656,22632,6.535,Norway,NOR,6.535,75.41,5431,1225,Europe,15976,2007
6656,22632,6.535,Norway,NOR,6.535,75.41,5431,1225,Europe,15976,2007
346,5904,5.105,Slovenia,SVN,5.105,84.443,15,331,Europe,5558,2007
346,5904,5.105,Slovenia,SVN,5.105,84.443,15,331,Europe,5558,2007
346,5904,5.105,Slovenia,SVN,5.105,84.443,15,331,Europe,5558,2007
346,5904,5.105,Slovenia,SVN,5.105,84.443,15,331,Europe,5558,2007
346,5904,5.105,Slovenia,SVN,5.105,84.443,15,331,Europe,5558,2007
346,5904,5.105,Slovenia,SVN,5.105,84.443,15,331,Europe,5558,2007
346,5904,5.105,Slovenia,SVN,5.105,84.443,15,331,Europe,5558,2007
2925,17955,6.215,Sweden,SWE,6.215,74.976,398,2527,Europe,15030,2007
2925,17955,6.215,Sweden,SWE,6.215,74.976,398,2527,Europe,15030,2007
2925,17955,6.215,Sweden,SWE,6.215,74.976,398,2527,Europe,15030,2007
2925,17955,6.215,Sweden,SWE,6.215,74.976,398,2527,Europe,15030,2007
2925,17955,6.215,Sweden,SWE,6.215,74.976,398,2527,Europe,15030,2007
2925,17955,6.215,Sweden,SWE,6.215,74.976,398,2527,Europe,15030,2007
2925,17955,6.215,Sweden,SWE,6.215,74.976,398,2527,Europe,15030,2007
6163,39675,6.151,Ukraine,UKR,6.151,80.903,2723,3440,Europe,33512,2007
6163,39675,6.151,Ukraine,UKR,6.151,80.903,2723,3440,Europe,33512,2007
6163,39675,6.151,Ukraine,UKR,6.151,80.903,2723,3440,Europe,33512,2007
6163,39675,6.151,Ukraine,UKR,6.151,80.903,2723,3440,Europe,33512,2007
6163,39675,6.151,Ukraine,UKR,6.151,80.903,2723,3440,Europe,33512,2007
6163,39675,6.151,Ukraine,UKR,6.151,80.903,2723,3440,Europe,33512,2007
6163,39675,6.151,Ukraine,UKR,6.151,80.903,2723,3440,Europe,33512,2007
24999,65483,5.164,United Kingdom,GBR,5.164,58.652,7624,17375,Europe,40484,2007
24999,65483,5.164,United Kingdom,GBR,5.164,58.652,7624,17375,Europe,40484,2007
24999,65483,5.164,United Kingdom,GBR,5.164,58.652,7624,17375,Europe,40484,2007
24999,65483,5.164,United Kingdom,GBR,5.164,58.652,7624,17375,Europe,40484,2007
24999,65483,5.164,United Kingdom,GBR,5.164,58.652,7624,17375,Europe,40484,2007
24999,65483,5.164,United Kingdom,GBR,5.164,58.652,7624,17375,Europe,40484,2007
24999,65483,5.164,United Kingdom,GBR,5.164,58.652,7624,17375,Europe,40484,2007
2627,16106,5.297,Austria,AUT,5.297,56.15,329,2298,Europe,13479,2008
2627,16106,5.297,Austria,AUT,5.297,56.15,329,2298,Europe,13479,2008
2627,16106,5.297,Austria,AUT,5.297,56.15,329,2298,Europe,13479,2008
2627,16106,5.297,Austria,AUT,5.297,56.15,329,2298,Europe,13479,2008
2627,16106,5.297,Austria,AUT,5.297,56.15,329,2298,Europe,13479,2008
2627,16106,5.297,Austria,AUT,5.297,56.15,329,2298,Europe,13479,2008
2627,16106,5.297,Austria,AUT,5.297,56.15,329,2298,Europe,13479,2008
708,29605,6.274,Belgium,BEL,6.274,62.102,133,575,Europe,28897,2008
708,29605,6.274,Belgium,BEL,6.274,62.102,133,575,Europe,28897,2008
708,29605,6.274,Belgium,BEL,6.274,62.102,133,575,Europe,28897,2008
708,29605,6.274,Belgium,BEL,6.274,62.102,133,575,Europe,28897,2008
708,29605,6.274,Belgium,BEL,6.274,62.102,133,575,Europe,28897,2008
708,29605,6.274,Belgium,BEL,6.274,62.102,133,575,Europe,28897,2008
708,29605,6.274,Belgium,BEL,6.274,62.102,133,575,Europe,28897,2008
1829,9848,7.492,Denmark,DNK,7.492,75.703,195,1634,Europe,8019,2008
1829,9848,7.492,Denmark,DNK,7.492,75.703,195,1634,Europe,8019,2008
1829,9848,7.492,Denmark,DNK,7.492,75.703,195,1634,Europe,8019,2008
1829,9848,7.492,Denmark,DNK,7.492,75.703,195,1634,Europe,8019,2008
1829,9848,7.492,Denmark,DNK,7.492,75.703,195,1634,Europe,8019,2008
1829,9848,7.492,Denmark,DNK,7.492,75.703,195,1634,Europe,8019,2008
1829,9848,7.492,Denmark,DNK,7.492,75.703,195,1634,Europe,8019,2008
1946,9274,5.847,Finland,FIN,5.847,95.074,147,1799,Europe,7328,2008
1946,9274,5.847,Finland,FIN,5.847,95.074,147,1799,Europe,7328,2008
1946,9274,5.847,Finland,FIN,5.847,95.074,147,1799,Europe,7328,2008
1946,9274,5.847,Finland,FIN,5.847,95.074,147,1799,Europe,7328,2008
1946,9274,5.847,Finland,FIN,5.847,95.074,147,1799,Europe,7328,2008
1946,9274,5.847,Finland,FIN,5.847,95.074,147,1799,Europe,7328,2008
1946,9274,5.847,Finland,FIN,5.847,95.074,147,1799,Europe,7328,2008
81,4678,7.226,Iceland,ISL,7.226,74.103,31,50,Europe,4597,2008
81,4678,7.226,Iceland,ISL,7.226,74.103,31,50,Europe,4597,2008
81,4678,7.226,Iceland,ISL,7.226,74.103,31,50,Europe,4597,2008
81,4678,7.226,Iceland,ISL,7.226,74.103,31,50,Europe,4597,2008
81,4678,7.226,Iceland,ISL,7.226,74.103,31,50,Europe,4597,2008
81,4678,7.226,Iceland,ISL,7.226,74.103,31,50,Europe,4597,2008
81,4678,7.226,Iceland,ISL,7.226,74.103,31,50,Europe,4597,2008
105,6437,16.693,Lithuania,LTU,16.693,85.123,18,87,Europe,6332,2008
105,6437,16.693,Lithuania,LTU,16.693,85.123,18,87,Europe,6332,2008
105,6437,16.693,Lithuania,LTU,16.693,85.123,18,87,Europe,6332,2008
105,6437,16.693,Lithuania,LTU,16.693,85.123,18,87,Europe,6332,2008
105,6437,16.693,Lithuania,LTU,16.693,85.123,18,87,Europe,6332,2008
105,6437,16.693,Lithuania,LTU,16.693,85.123,18,87,Europe,6332,2008
105,6437,16.693,Lithuania,LTU,16.693,85.123,18,87,Europe,6332,2008
2732,2732,5.119,Netherlands,NLD,5.119,61.447,311,2421,Europe,0,2008
2732,2732,5.119,Netherlands,NLD,5.119,61.447,311,2421,Europe,0,2008
2732,2732,5.119,Netherlands,NLD,5.119,61.447,311,2421,Europe,0,2008
2732,2732,5.119,Netherlands,NLD,5.119,61.447,311,2421,Europe,0,2008
2732,2732,5.119,Netherlands,NLD,5.119,61.447,311,2421,Europe,0,2008
2732,2732,5.119,Netherlands,NLD,5.119,61.447,311,2421,Europe,0,2008
2732,2732,5.119,Netherlands,NLD,5.119,61.447,311,2421,Europe,0,2008
5430,21754,6.289,Norway,NOR,6.289,72.337,4280,1150,Europe,16324,2008
5430,21754,6.289,Norway,NOR,6.289,72.337,4280,1150,Europe,16324,2008
5430,21754,6.289,Norway,NOR,6.289,72.337,4280,1150,Europe,16324,2008
5430,21754,6.289,Norway,NOR,6.289,72.337,4280,1150,Europe,16324,2008
5430,21754,6.289,Norway,NOR,6.289,72.337,4280,1150,Europe,16324,2008
5430,21754,6.289,Norway,NOR,6.289,72.337,4280,1150,Europe,16324,2008
5430,21754,6.289,Norway,NOR,6.289,72.337,4280,1150,Europe,16324,2008
307,5501,5.106,Slovenia,SVN,5.106,85.175,6,301,Europe,5194,2008
307,5501,5.106,Slovenia,SVN,5.106,85.175,6,301,Europe,5194,2008
307,5501,5.106,Slovenia,SVN,5.106,85.175,6,301,Europe,5194,2008
307,5501,5.106,Slovenia,SVN,5.106,85.175,6,301,Europe,5194,2008
307,5501,5.106,Slovenia,SVN,5.106,85.175,6,301,Europe,5194,2008
307,5501,5.106,Slovenia,SVN,5.106,85.175,6,301,Europe,5194,2008
307,5501,5.106,Slovenia,SVN,5.106,85.175,6,301,Europe,5194,2008
2855,17853,6.391,Sweden,SWE,6.391,71.124,306,2549,Europe,14998,2008
2855,17853,6.391,Sweden,SWE,6.391,71.124,306,2549,Europe,14998,2008
2855,17853,6.391,Sweden,SWE,6.391,71.124,306,2549,Europe,14998,2008
2855,17853,6.391,Sweden,SWE,6.391,71.124,306,2549,Europe,14998,2008
2855,17853,6.391,Sweden,SWE,6.391,71.124,306,2549,Europe,14998,2008
2855,17853,6.391,Sweden,SWE,6.391,71.124,306,2549,Europe,14998,2008
2855,17853,6.391,Sweden,SWE,6.391,71.124,306,2549,Europe,14998,2008
5697,38716,6.43,Ukraine,UKR,6.43,83.537,2872,2825,Europe,33019,2008
5697,38716,6.43,Ukraine,UKR,6.43,83.537,2872,2825,Europe,33019,2008
5697,38716,6.43,Ukraine,UKR,6.43,83.537,2872,2825,Europe,33019,2008
5697,38716,6.43,Ukraine,UKR,6.43,83.537,2872,2825,Europe,33019,2008
5697,38716,6.43,Ukraine,UKR,6.43,83.537,2872,2825,Europe,33019,2008
5697,38716,6.43,Ukraine,UKR,6.43,83.537,2872,2825,Europe,33019,2008
5697,38716,6.43,Ukraine,UKR,6.43,83.537,2872,2825,Europe,33019,2008
23379,59084,5.121,United Kingdom,GBR,5.121,56.874,6856,16523,Europe,35705,2008
23379,59084,5.121,United Kingdom,GBR,5.121,56.874,6856,16523,Europe,35705,2008
23379,59084,5.121,United Kingdom,GBR,5.121,56.874,6856,16523,Europe,35705,2008
23379,59084,5.121,United Kingdom,GBR,5.121,56.874,6856,16523,Europe,35705,2008
23379,59084,5.121,United Kingdom,GBR,5.121,56.874,6856,16523,Europe,35705,2008
23379,59084,5.121,United Kingdom,GBR,5.121,56.874,6856,16523,Europe,35705,2008
23379,59084,5.121,United Kingdom,GBR,5.121,56.874,6856,16523,Europe,35705,2008
2555,14254,5.767,Austria,AUT,5.767,60.717,292,2263,Europe,11699,2009
2555,14254,5.767,Austria,AUT,5.767,60.717,292,2263,Europe,11699,2009
2555,14254,5.767,Austria,AUT,5.767,60.717,292,2263,Europe,11699,2009
2555,14254,5.767,Austria,AUT,5.767,60.717,292,2263,Europe,11699,2009
2555,14254,5.767,Austria,AUT,5.767,60.717,292,2263,Europe,11699,2009
2555,14254,5.767,Austria,AUT,5.767,60.717,292,2263,Europe,11699,2009
2555,14254,5.767,Austria,AUT,5.767,60.717,292,2263,Europe,11699,2009
817,26383,6.398,Belgium,BEL,6.398,65.198,148,669,Europe,25566,2009
817,26383,6.398,Belgium,BEL,6.398,65.198,148,669,Europe,25566,2009
817,26383,6.398,Belgium,BEL,6.398,65.198,148,669,Europe,25566,2009
817,26383,6.398,Belgium,BEL,6.398,65.198,148,669,Europe,25566,2009
817,26383,6.398,Belgium,BEL,6.398,65.198,148,669,Europe,25566,2009
817,26383,6.398,Belgium,BEL,6.398,65.198,148,669,Europe,25566,2009
817,26383,6.398,Belgium,BEL,6.398,65.198,148,669,Europe,25566,2009
1649,7724,8.488,Denmark,DNK,8.488,74.301,131,1518,Europe,6075,2009
1649,7724,8.488,Denmark,DNK,8.488,74.301,131,1518,Europe,6075,2009
1649,7724,8.488,Denmark,DNK,8.488,74.301,131,1518,Europe,6075,2009
1649,7724,8.488,Denmark,DNK,8.488,74.301,131,1518,Europe,6075,2009
1649,7724,8.488,Denmark,DNK,8.488,74.301,131,1518,Europe,6075,2009
1649,7724,8.488,Denmark,DNK,8.488,74.301,131,1518,Europe,6075,2009
1649,7724,8.488,Denmark,DNK,8.488,74.301,131,1518,Europe,6075,2009
1933,7497,6.485,Finland,FIN,6.485,91.83,127,1806,Europe,5564,2009
1933,7497,6.485,Finland,FIN,6.485,91.83,127,1806,Europe,5564,2009
1933,7497,6.485,Finland,FIN,6.485,91.83,127,1806,Europe,5564,2009
1933,7497,6.485,Finland,FIN,6.485,91.83,127,1806,Europe,5564,2009
1933,7497,6.485,Finland,FIN,6.485,91.83,127,1806,Europe,5564,2009
1933,7497,6.485,Finland,FIN,6.485,91.83,127,1806,Europe,5564,2009
1933,7497,6.485,Finland,FIN,6.485,91.83,127,1806,Europe,5564,2009
86,3660,7.375,Iceland,ISL,7.375,74.323,22,64,Europe,3574,2009
86,3660,7.375,Iceland,ISL,7.375,74.323,22,64,Europe,3574,2009
86,3660,7.375,Iceland,ISL,7.375,74.323,22,64,Europe,3574,2009
86,3660,7.375,Iceland,ISL,7.375,74.323,22,64,Europe,3574,2009
86,3660,7.375,Iceland,ISL,7.375,74.323,22,64,Europe,3574,2009
86,3660,7.375,Iceland,ISL,7.375,74.323,22,64,Europe,3574,2009
86,3660,7.375,Iceland,ISL,7.375,74.323,22,64,Europe,3574,2009
107,4572,19.258,Lithuania,LTU,19.258,88.464,16,91,Europe,4465,2009
107,4572,19.258,Lithuania,LTU,19.258,88.464,16,91,Europe,4465,2009
107,4572,19.258,Lithuania,LTU,19.258,88.464,16,91,Europe,4465,2009
107,4572,19.258,Lithuania,LTU,19.258,88.464,16,91,Europe,4465,2009
107,4572,19.258,Lithuania,LTU,19.258,88.464,16,91,Europe,4465,2009
107,4572,19.258,Lithuania,LTU,19.258,88.464,16,91,Europe,4465,2009
107,4572,19.258,Lithuania,LTU,19.258,88.464,16,91,Europe,4465,2009
2854,2854,5.495,Netherlands,NLD,5.495,62.435,279,2575,Europe,0,2009
2854,2854,5.495,Netherlands,NLD,5.495,62.435,279,2575,Europe,0,2009
2854,2854,5.495,Netherlands,NLD,5.495,62.435,279,2575,Europe,0,2009
2854,2854,5.495,Netherlands,NLD,5.495,62.435,279,2575,Europe,0,2009
2854,2854,5.495,Netherlands,NLD,5.495,62.435,279,2575,Europe,0,2009
2854,2854,5.495,Netherlands,NLD,5.495,62.435,279,2575,Europe,0,2009
2854,2854,5.495,Netherlands,NLD,5.495,62.435,279,2575,Europe,0,2009
3604,17211,7.1,Norway,NOR,7.1,72.706,2358,1246,Europe,13607,2009
3604,17211,7.1,Norway,NOR,7.1,72.706,2358,1246,Europe,13607,2009
3604,17211,7.1,Norway,NOR,7.1,72.706,2358,1246,Europe,13607,2009
3604,17211,7.1,Norway,NOR,7.1,72.706,2358,1246,Europe,13607,2009
3604,17211,7.1,Norway,NOR,7.1,72.706,2358,1246,Europe,13607,2009
3604,17211,7.1,Norway,NOR,7.1,72.706,2358,1246,Europe,13607,2009
3604,17211,7.1,Norway,NOR,7.1,72.706,2358,1246,Europe,13607,2009
385,4460,5.569,Slovenia,SVN,5.569,85.834,12,373,Europe,4075,2009
385,4460,5.569,Slovenia,SVN,5.569,85.834,12,373,Europe,4075,2009
385,4460,5.569,Slovenia,SVN,5.569,85.834,12,373,Europe,4075,2009
385,4460,5.569,Slovenia,SVN,5.569,85.834,12,373,Europe,4075,2009
385,4460,5.569,Slovenia,SVN,5.569,85.834,12,373,Europe,4075,2009
385,4460,5.569,Slovenia,SVN,5.569,85.834,12,373,Europe,4075,2009
385,4460,5.569,Slovenia,SVN,5.569,85.834,12,373,Europe,4075,2009
2649,15355,6.858,Sweden,SWE,6.858,71.452,463,2186,Europe,12706,2009
2649,15355,6.858,Sweden,SWE,6.858,71.452,463,2186,Europe,12706,2009
2649,15355,6.858,Sweden,SWE,6.858,71.452,463,2186,Europe,12706,2009
2649,15355,6.858,Sweden,SWE,6.858,71.452,463,2186,Europe,12706,2009
2649,15355,6.858,Sweden,SWE,6.858,71.452,463,2186,Europe,12706,2009
2649,15355,6.858,Sweden,SWE,6.858,71.452,463,2186,Europe,12706,2009
2649,15355,6.858,Sweden,SWE,6.858,71.452,463,2186,Europe,12706,2009
4814,31248,7.311,Ukraine,UKR,7.311,84.198,2380,2434,Europe,26434,2009
4814,31248,7.311,Ukraine,UKR,7.311,84.198,2380,2434,Europe,26434,2009
4814,31248,7.311,Ukraine,UKR,7.311,84.198,2380,2434,Europe,26434,2009
4814,31248,7.311,Ukraine,UKR,7.311,84.198,2380,2434,Europe,26434,2009
4814,31248,7.311,Ukraine,UKR,7.311,84.198,2380,2434,Europe,26434,2009
4814,31248,7.311,Ukraine,UKR,7.311,84.198,2380,2434,Europe,26434,2009
4814,31248,7.311,Ukraine,UKR,7.311,84.198,2380,2434,Europe,26434,2009
22465,56718,5.312,United Kingdom,GBR,5.312,58.153,6480,15985,Europe,34253,2009
22465,56718,5.312,United Kingdom,GBR,5.312,58.153,6480,15985,Europe,34253,2009
22465,56718,5.312,United Kingdom,GBR,5.312,58.153,6480,15985,Europe,34253,2009
22465,56718,5.312,United Kingdom,GBR,5.312,58.153,6480,15985,Europe,34253,2009
22465,56718,5.312,United Kingdom,GBR,5.312,58.153,6480,15985,Europe,34253,2009
22465,56718,5.312,United Kingdom,GBR,5.312,58.153,6480,15985,Europe,34253,2009
22465,56718,5.312,United Kingdom,GBR,5.312,58.153,6480,15985,Europe,34253,2009
2673,12970,5.733,Austria,AUT,5.733,68.732,249,2424,Europe,10297,2010
2673,12970,5.733,Austria,AUT,5.733,68.732,249,2424,Europe,10297,2010
2673,12970,5.733,Austria,AUT,5.733,68.732,249,2424,Europe,10297,2010
2673,12970,5.733,Austria,AUT,5.733,68.732,249,2424,Europe,10297,2010
2673,12970,5.733,Austria,AUT,5.733,68.732,249,2424,Europe,10297,2010
2673,12970,5.733,Austria,AUT,5.733,68.732,249,2424,Europe,10297,2010
2673,12970,5.733,Austria,AUT,5.733,68.732,249,2424,Europe,10297,2010
760,26559,6.397,Belgium,BEL,6.397,67.711,140,620,Europe,25799,2010
760,26559,6.397,Belgium,BEL,6.397,67.711,140,620,Europe,25799,2010
760,26559,6.397,Belgium,BEL,6.397,67.711,140,620,Europe,25799,2010
760,26559,6.397,Belgium,BEL,6.397,67.711,140,620,Europe,25799,2010
760,26559,6.397,Belgium,BEL,6.397,67.711,140,620,Europe,25799,2010
760,26559,6.397,Belgium,BEL,6.397,67.711,140,620,Europe,25799,2010
760,26559,6.397,Belgium,BEL,6.397,67.711,140,620,Europe,25799,2010
1768,7518,8.618,Denmark,DNK,8.618,73.62,142,1626,Europe,5750,2010
1768,7518,8.618,Denmark,DNK,8.618,73.62,142,1626,Europe,5750,2010
1768,7518,8.618,Denmark,DNK,8.618,73.62,142,1626,Europe,5750,2010
1768,7518,8.618,Denmark,DNK,8.618,73.62,142,1626,Europe,5750,2010
1768,7518,8.618,Denmark,DNK,8.618,73.62,142,1626,Europe,5750,2010
1768,7518,8.618,Denmark,DNK,8.618,73.62,142,1626,Europe,5750,2010
1768,7518,8.618,Denmark,DNK,8.618,73.62,142,1626,Europe,5750,2010
1833,7303,6.541,Finland,FIN,6.541,94.119,102,1731,Europe,5470,2010
1833,7303,6.541,Finland,FIN,6.541,94.119,102,1731,Europe,5470,2010
1833,7303,6.541,Finland,FIN,6.541,94.119,102,1731,Europe,5470,2010
1833,7303,6.541,Finland,FIN,6.541,94.119,102,1731,Europe,5470,2010
1833,7303,6.541,Finland,FIN,6.541,94.119,102,1731,Europe,5470,2010
1833,7303,6.541,Finland,FIN,6.541,94.119,102,1731,Europe,5470,2010
1833,7303,6.541,Finland,FIN,6.541,94.119,102,1731,Europe,5470,2010
76,3597,7.201,Iceland,ISL,7.201,78.353,19,57,Europe,3521,2010
76,3597,7.201,Iceland,ISL,7.201,78.353,19,57,Europe,3521,2010
76,3597,7.201,Iceland,ISL,7.201,78.353,19,57,Europe,3521,2010
76,3597,7.201,Iceland,ISL,7.201,78.353,19,57,Europe,3521,2010
76,3597,7.201,Iceland,ISL,7.201,78.353,19,57,Europe,3521,2010
76,3597,7.201,Iceland,ISL,7.201,78.353,19,57,Europe,3521,2010
76,3597,7.201,Iceland,ISL,7.201,78.353,19,57,Europe,3521,2010
114,4388,18.314,Lithuania,LTU,18.314,85.662,6,108,Europe,4274,2010
114,4388,18.314,Lithuania,LTU,18.314,85.662,6,108,Europe,4274,2010
114,4388,18.314,Lithuania,LTU,18.314,85.662,6,108,Europe,4274,2010
114,4388,18.314,Lithuania,LTU,18.314,85.662,6,108,Europe,4274,2010
114,4388,18.314,Lithuania,LTU,18.314,85.662,6,108,Europe,4274,2010
114,4388,18.314,Lithuania,LTU,18.314,85.662,6,108,Europe,4274,2010
114,4388,18.314,Lithuania,LTU,18.314,85.662,6,108,Europe,4274,2010
2767,2767,5.556,Netherlands,NLD,5.556,65.159,240,2527,Europe,0,2010
2767,2767,5.556,Netherlands,NLD,5.556,65.159,240,2527,Europe,0,2010
2767,2767,5.556,Netherlands,NLD,5.556,65.159,240,2527,Europe,0,2010
2767,2767,5.556,Netherlands,NLD,5.556,65.159,240,2527,Europe,0,2010
2767,2767,5.556,Netherlands,NLD,5.556,65.159,240,2527,Europe,0,2010
2767,2767,5.556,Netherlands,NLD,5.556,65.159,240,2527,Europe,0,2010
2767,2767,5.556,Netherlands,NLD,5.556,65.159,240,2527,Europe,0,2010
1813,15648,6.75,Norway,NOR,6.75,72.887,696,1117,Europe,13835,2010
1813,15648,6.75,Norway,NOR,6.75,72.887,696,1117,Europe,13835,2010
1813,15648,6.75,Norway,NOR,6.75,72.887,696,1117,Europe,13835,2010
1813,15648,6.75,Norway,NOR,6.75,72.887,696,1117,Europe,13835,2010
1813,15648,6.75,Norway,NOR,6.75,72.887,696,1117,Europe,13835,2010
1813,15648,6.75,Norway,NOR,6.75,72.887,696,1117,Europe,13835,2010
1813,15648,6.75,Norway,NOR,6.75,72.887,696,1117,Europe,13835,2010
453,4299,5.568,Slovenia,SVN,5.568,88.266,11,442,Europe,3846,2010
453,4299,5.568,Slovenia,SVN,5.568,88.266,11,442,Europe,3846,2010
453,4299,5.568,Slovenia,SVN,5.568,88.266,11,442,Europe,3846,2010
453,4299,5.568,Slovenia,SVN,5.568,88.266,11,442,Europe,3846,2010
453,4299,5.568,Slovenia,SVN,5.568,88.266,11,442,Europe,3846,2010
453,4299,5.568,Slovenia,SVN,5.568,88.266,11,442,Europe,3846,2010
453,4299,5.568,Slovenia,SVN,5.568,88.266,11,442,Europe,3846,2010
2549,15211,6.622,Sweden,SWE,6.622,74.684,353,2196,Europe,12662,2010
2549,15211,6.622,Sweden,SWE,6.622,74.684,353,2196,Europe,12662,2010
2549,15211,6.622,Sweden,SWE,6.622,74.684,353,2196,Europe,12662,2010
2549,15211,6.622,Sweden,SWE,6.622,74.684,353,2196,Europe,12662,2010
2549,15211,6.622,Sweden,SWE,6.622,74.684,353,2196,Europe,12662,2010
2549,15211,6.622,Sweden,SWE,6.622,74.684,353,2196,Europe,12662,2010
2549,15211,6.622,Sweden,SWE,6.622,74.684,353,2196,Europe,12662,2010
5312,34227,4.804625,Ukraine,UKR,0,81.934,2756,2556,Europe,28915,2010
5312,34227,4.804625,Ukraine,UKR,0,81.934,2756,2556,Europe,28915,2010
5312,34227,4.804625,Ukraine,UKR,0,81.934,2756,2556,Europe,28915,2010
5312,34227,4.804625,Ukraine,UKR,0,81.934,2756,2556,Europe,28915,2010
5312,34227,4.804625,Ukraine,UKR,0,81.934,2756,2556,Europe,28915,2010
5312,34227,4.804625,Ukraine,UKR,0,81.934,2756,2556,Europe,28915,2010
5312,34227,4.804625,Ukraine,UKR,0,81.934,2756,2556,Europe,28915,2010
21929,58413,5.955,United Kingdom,GBR,5.955,59.067,6439,15490,Europe,36484,2010
21929,58413,5.955,United Kingdom,GBR,5.955,59.067,6439,15490,Europe,36484,2010
21929,58413,5.955,United Kingdom,GBR,5.955,59.067,6439,15490,Europe,36484,2010
21929,58413,5.955,United Kingdom,GBR,5.955,59.067,6439,15490,Europe,36484,2010
21929,58413,5.955,United Kingdom,GBR,5.955,59.067,6439,15490,Europe,36484,2010
21929,58413,5.955,United Kingdom,GBR,5.955,59.067,6439,15490,Europe,36484,2010
21929,58413,5.955,United Kingdom,GBR,5.955,59.067,6439,15490,Europe,36484,2010
2430,11954,5.619,Austria,AUT,5.619,71.011,276,2154,Europe,9524,2011
2430,11954,5.619,Austria,AUT,5.619,71.011,276,2154,Europe,9524,2011
2430,11954,5.619,Austria,AUT,5.619,71.011,276,2154,Europe,9524,2011
2430,11954,5.619,Austria,AUT,5.619,71.011,276,2154,Europe,9524,2011
2430,11954,5.619,Austria,AUT,5.619,71.011,276,2154,Europe,9524,2011
2430,11954,5.619,Austria,AUT,5.619,71.011,276,2154,Europe,9524,2011
2430,11954,5.619,Austria,AUT,5.619,71.011,276,2154,Europe,9524,2011
763,26724,6.365,Belgium,BEL,6.365,69.726,127,636,Europe,25961,2011
763,26724,6.365,Belgium,BEL,6.365,69.726,127,636,Europe,25961,2011
763,26724,6.365,Belgium,BEL,6.365,69.726,127,636,Europe,25961,2011
763,26724,6.365,Belgium,BEL,6.365,69.726,127,636,Europe,25961,2011
763,26724,6.365,Belgium,BEL,6.365,69.726,127,636,Europe,25961,2011
763,26724,6.365,Belgium,BEL,6.365,69.726,127,636,Europe,25961,2011
763,26724,6.365,Belgium,BEL,6.365,69.726,127,636,Europe,25961,2011
1771,7320,8.547,Denmark,DNK,8.547,76.801,197,1574,Europe,5549,2011
1771,7320,8.547,Denmark,DNK,8.547,76.801,197,1574,Europe,5549,2011
1771,7320,8.547,Denmark,DNK,8.547,76.801,197,1574,Europe,5549,2011
1771,7320,8.547,Denmark,DNK,8.547,76.801,197,1574,Europe,5549,2011
1771,7320,8.547,Denmark,DNK,8.547,76.801,197,1574,Europe,5549,2011
1771,7320,8.547,Denmark,DNK,8.547,76.801,197,1574,Europe,5549,2011
1771,7320,8.547,Denmark,DNK,8.547,76.801,197,1574,Europe,5549,2011
1774,7221,6.482,Finland,FIN,6.482,95.602,124,1650,Europe,5447,2011
1774,7221,6.482,Finland,FIN,6.482,95.602,124,1650,Europe,5447,2011
1774,7221,6.482,Finland,FIN,6.482,95.602,124,1650,Europe,5447,2011
1774,7221,6.482,Finland,FIN,6.482,95.602,124,1650,Europe,5447,2011
1774,7221,6.482,Finland,FIN,6.482,95.602,124,1650,Europe,5447,2011
1774,7221,6.482,Finland,FIN,6.482,95.602,124,1650,Europe,5447,2011
1774,7221,6.482,Finland,FIN,6.482,95.602,124,1650,Europe,5447,2011
71,3773,7.037,Iceland,ISL,7.037,80.942,21,50,Europe,3702,2011
71,3773,7.037,Iceland,ISL,7.037,80.942,21,50,Europe,3702,2011
71,3773,7.037,Iceland,ISL,7.037,80.942,21,50,Europe,3702,2011
71,3773,7.037,Iceland,ISL,7.037,80.942,21,50,Europe,3702,2011
71,3773,7.037,Iceland,ISL,7.037,80.942,21,50,Europe,3702,2011
71,3773,7.037,Iceland,ISL,7.037,80.942,21,50,Europe,3702,2011
71,3773,7.037,Iceland,ISL,7.037,80.942,21,50,Europe,3702,2011
108,4423,17.695,Lithuania,LTU,17.695,80.765,15,93,Europe,4315,2011
108,4423,17.695,Lithuania,LTU,17.695,80.765,15,93,Europe,4315,2011
108,4423,17.695,Lithuania,LTU,17.695,80.765,15,93,Europe,4315,2011
108,4423,17.695,Lithuania,LTU,17.695,80.765,15,93,Europe,4315,2011
108,4423,17.695,Lithuania,LTU,17.695,80.765,15,93,Europe,4315,2011
108,4423,17.695,Lithuania,LTU,17.695,80.765,15,93,Europe,4315,2011
108,4423,17.695,Lithuania,LTU,17.695,80.765,15,93,Europe,4315,2011
2895,2895,5.526,Netherlands,NLD,5.526,77.646,310,2585,Europe,0,2011
2895,2895,5.526,Netherlands,NLD,5.526,77.646,310,2585,Europe,0,2011
2895,2895,5.526,Netherlands,NLD,5.526,77.646,310,2585,Europe,0,2011
2895,2895,5.526,Netherlands,NLD,5.526,77.646,310,2585,Europe,0,2011
2895,2895,5.526,Netherlands,NLD,5.526,77.646,310,2585,Europe,0,2011
2895,2895,5.526,Netherlands,NLD,5.526,77.646,310,2585,Europe,0,2011
2895,2895,5.526,Netherlands,NLD,5.526,77.646,310,2585,Europe,0,2011
1776,16676,6.456,Norway,NOR,6.456,73.086,654,1122,Europe,14900,2011
1776,16676,6.456,Norway,NOR,6.456,73.086,654,1122,Europe,14900,2011
1776,16676,6.456,Norway,NOR,6.456,73.086,654,1122,Europe,14900,2011
1776,16676,6.456,Norway,NOR,6.456,73.086,654,1122,Europe,14900,2011
1776,16676,6.456,Norway,NOR,6.456,73.086,654,1122,Europe,14900,2011
1776,16676,6.456,Norway,NOR,6.456,73.086,654,1122,Europe,14900,2011
1776,16676,6.456,Norway,NOR,6.456,73.086,654,1122,Europe,14900,2011
481,4107,5.57,Slovenia,SVN,5.57,84.974,11,470,Europe,3626,2011
481,4107,5.57,Slovenia,SVN,5.57,84.974,11,470,Europe,3626,2011
481,4107,5.57,Slovenia,SVN,5.57,84.974,11,470,Europe,3626,2011
481,4107,5.57,Slovenia,SVN,5.57,84.974,11,470,Europe,3626,2011
481,4107,5.57,Slovenia,SVN,5.57,84.974,11,470,Europe,3626,2011
481,4107,5.57,Slovenia,SVN,5.57,84.974,11,470,Europe,3626,2011
481,4107,5.57,Slovenia,SVN,5.57,84.974,11,470,Europe,3626,2011
2341,14332,6.491,Sweden,SWE,6.491,73.945,337,2004,Europe,11991,2011
2341,14332,6.491,Sweden,SWE,6.491,73.945,337,2004,Europe,11991,2011
2341,14332,6.491,Sweden,SWE,6.491,73.945,337,2004,Europe,11991,2011
2341,14332,6.491,Sweden,SWE,6.491,73.945,337,2004,Europe,11991,2011
2341,14332,6.491,Sweden,SWE,6.491,73.945,337,2004,Europe,11991,2011
2341,14332,6.491,Sweden,SWE,6.491,73.945,337,2004,Europe,11991,2011
2341,14332,6.491,Sweden,SWE,6.491,73.945,337,2004,Europe,11991,2011
5253,35254,6.162,Ukraine,UKR,6.162,83.32,2604,2649,Europe,30001,2011
5253,35254,6.162,Ukraine,UKR,6.162,83.32,2604,2649,Europe,30001,2011
5253,35254,6.162,Ukraine,UKR,6.162,83.32,2604,2649,Europe,30001,2011
5253,35254,6.162,Ukraine,UKR,6.162,83.32,2604,2649,Europe,30001,2011
5253,35254,6.162,Ukraine,UKR,6.162,83.32,2604,2649,Europe,30001,2011
5253,35254,6.162,Ukraine,UKR,6.162,83.32,2604,2649,Europe,30001,2011
5253,35254,6.162,Ukraine,UKR,6.162,83.32,2604,2649,Europe,30001,2011
22259,61726,5.752,United Kingdom,GBR,5.752,58.986,6916,15343,Europe,39467,2011
22259,61726,5.752,United Kingdom,GBR,5.752,58.986,6916,15343,Europe,39467,2011
22259,61726,5.752,United Kingdom,GBR,5.752,58.986,6916,15343,Europe,39467,2011
22259,61726,5.752,United Kingdom,GBR,5.752,58.986,6916,15343,Europe,39467,2011
22259,61726,5.752,United Kingdom,GBR,5.752,58.986,6916,15343,Europe,39467,2011
22259,61726,5.752,United Kingdom,GBR,5.752,58.986,6916,15343,Europe,39467,2011
22259,61726,5.752,United Kingdom,GBR,5.752,58.986,6916,15343,Europe,39467,2011
2552,12071,5.451,Austria,AUT,5.451,72.315,294,2258,Europe,9519,2012
2552,12071,5.451,Austria,AUT,5.451,72.315,294,2258,Europe,9519,2012
2552,12071,5.451,Austria,AUT,5.451,72.315,294,2258,Europe,9519,2012
2552,12071,5.451,Austria,AUT,5.451,72.315,294,2258,Europe,9519,2012
2552,12071,5.451,Austria,AUT,5.451,72.315,294,2258,Europe,9519,2012
2552,12071,5.451,Austria,AUT,5.451,72.315,294,2258,Europe,9519,2012
2552,12071,5.451,Austria,AUT,5.451,72.315,294,2258,Europe,9519,2012
882,25415,4.1499375,Belgium,BEL,0,71.244,127,755,Europe,24533,2012
882,25415,4.1499375,Belgium,BEL,0,71.244,127,755,Europe,24533,2012
882,25415,4.1499375,Belgium,BEL,0,71.244,127,755,Europe,24533,2012
882,25415,4.1499375,Belgium,BEL,0,71.244,127,755,Europe,24533,2012
882,25415,4.1499375,Belgium,BEL,0,71.244,127,755,Europe,24533,2012
882,25415,4.1499375,Belgium,BEL,0,71.244,127,755,Europe,24533,2012
882,25415,4.1499375,Belgium,BEL,0,71.244,127,755,Europe,24533,2012
1635,6667,6.088500000,Denmark,DNK,0,79.253,229,1406,Europe,5032,2012
1635,6667,6.088500000,Denmark,DNK,0,79.253,229,1406,Europe,5032,2012
1635,6667,6.088500000,Denmark,DNK,0,79.253,229,1406,Europe,5032,2012
1635,6667,6.088500000,Denmark,DNK,0,79.253,229,1406,Europe,5032,2012
1635,6667,6.088500000,Denmark,DNK,0,79.253,229,1406,Europe,5032,2012
1635,6667,6.088500000,Denmark,DNK,0,79.253,229,1406,Europe,5032,2012
1635,6667,6.088500000,Denmark,DNK,0,79.253,229,1406,Europe,5032,2012
1827,7207,7.193,Finland,FIN,7.193,93.281,129,1698,Europe,5380,2012
1827,7207,7.193,Finland,FIN,7.193,93.281,129,1698,Europe,5380,2012
1827,7207,7.193,Finland,FIN,7.193,93.281,129,1698,Europe,5380,2012
1827,7207,7.193,Finland,FIN,7.193,93.281,129,1698,Europe,5380,2012
1827,7207,7.193,Finland,FIN,7.193,93.281,129,1698,Europe,5380,2012
1827,7207,7.193,Finland,FIN,7.193,93.281,129,1698,Europe,5380,2012
1827,7207,7.193,Finland,FIN,7.193,93.281,129,1698,Europe,5380,2012
44,3699,5.359312500,Iceland,ISL,0,82.228,7,37,Europe,3655,2012
44,3699,5.359312500,Iceland,ISL,0,82.228,7,37,Europe,3655,2012
44,3699,5.359312500,Iceland,ISL,0,82.228,7,37,Europe,3655,2012
44,3699,5.359312500,Iceland,ISL,0,82.228,7,37,Europe,3655,2012
44,3699,5.359312500,Iceland,ISL,0,82.228,7,37,Europe,3655,2012
44,3699,5.359312500,Iceland,ISL,0,82.228,7,37,Europe,3655,2012
44,3699,5.359312500,Iceland,ISL,0,82.228,7,37,Europe,3655,2012
124,4346,8.6955,Lithuania,LTU,0,77.232,15,109,Europe,4222,2012
124,4346,8.6955,Lithuania,LTU,0,77.232,15,109,Europe,4222,2012
124,4346,8.6955,Lithuania,LTU,0,77.232,15,109,Europe,4222,2012
124,4346,8.6955,Lithuania,LTU,0,77.232,15,109,Europe,4222,2012
124,4346,8.6955,Lithuania,LTU,0,77.232,15,109,Europe,4222,2012
124,4346,8.6955,Lithuania,LTU,0,77.232,15,109,Europe,4222,2012
124,4346,8.6955,Lithuania,LTU,0,77.232,15,109,Europe,4222,2012
2713,2713,5.514,Netherlands,NLD,5.514,78.501,338,2375,Europe,0,2012
2713,2713,5.514,Netherlands,NLD,5.514,78.501,338,2375,Europe,0,2012
2713,2713,5.514,Netherlands,NLD,5.514,78.501,338,2375,Europe,0,2012
2713,2713,5.514,Netherlands,NLD,5.514,78.501,338,2375,Europe,0,2012
2713,2713,5.514,Netherlands,NLD,5.514,78.501,338,2375,Europe,0,2012
2713,2713,5.514,Netherlands,NLD,5.514,78.501,338,2375,Europe,0,2012
2713,2713,5.514,Netherlands,NLD,5.514,78.501,338,2375,Europe,0,2012
1564,16212,7.372,Norway,NOR,7.372,73.251,555,1009,Europe,14648,2012
1564,16212,7.372,Norway,NOR,7.372,73.251,555,1009,Europe,14648,2012
1564,16212,7.372,Norway,NOR,7.372,73.251,555,1009,Europe,14648,2012
1564,16212,7.372,Norway,NOR,7.372,73.251,555,1009,Europe,14648,2012
1564,16212,7.372,Norway,NOR,7.372,73.251,555,1009,Europe,14648,2012
1564,16212,7.372,Norway,NOR,7.372,73.251,555,1009,Europe,14648,2012
1564,16212,7.372,Norway,NOR,7.372,73.251,555,1009,Europe,14648,2012
0,1824,5.659,Slovenia,SVN,5.659,86.323,0,0,Europe,1824,2012
0,1824,5.659,Slovenia,SVN,5.659,86.323,0,0,Europe,1824,2012
0,1824,5.659,Slovenia,SVN,5.659,86.323,0,0,Europe,1824,2012
0,1824,5.659,Slovenia,SVN,5.659,86.323,0,0,Europe,1824,2012
0,1824,5.659,Slovenia,SVN,5.659,86.323,0,0,Europe,1824,2012
0,1824,5.659,Slovenia,SVN,5.659,86.323,0,0,Europe,1824,2012
0,1824,5.659,Slovenia,SVN,5.659,86.323,0,0,Europe,1824,2012
2436,13726,7.656,Sweden,SWE,7.656,69.616,148,2288,Europe,11290,2012
2436,13726,7.656,Sweden,SWE,7.656,69.616,148,2288,Europe,11290,2012
2436,13726,7.656,Sweden,SWE,7.656,69.616,148,2288,Europe,11290,2012
2436,13726,7.656,Sweden,SWE,7.656,69.616,148,2288,Europe,11290,2012
2436,13726,7.656,Sweden,SWE,7.656,69.616,148,2288,Europe,11290,2012
2436,13726,7.656,Sweden,SWE,7.656,69.616,148,2288,Europe,11290,2012
2436,13726,7.656,Sweden,SWE,7.656,69.616,148,2288,Europe,11290,2012
4955,37025,6.692,Ukraine,UKR,6.692,82.126,2464,2491,Europe,32070,2012
4955,37025,6.692,Ukraine,UKR,6.692,82.126,2464,2491,Europe,32070,2012
4955,37025,6.692,Ukraine,UKR,6.692,82.126,2464,2491,Europe,32070,2012
4955,37025,6.692,Ukraine,UKR,6.692,82.126,2464,2491,Europe,32070,2012
4955,37025,6.692,Ukraine,UKR,6.692,82.126,2464,2491,Europe,32070,2012
4955,37025,6.692,Ukraine,UKR,6.692,82.126,2464,2491,Europe,32070,2012
4955,37025,6.692,Ukraine,UKR,6.692,82.126,2464,2491,Europe,32070,2012
23235,66083,4.2080625,United Kingdom,GBR,0,59.223,7865,15370,Europe,42848,2012
23235,66083,4.2080625,United Kingdom,GBR,0,59.223,7865,15370,Europe,42848,2012
23235,66083,4.2080625,United Kingdom,GBR,0,59.223,7865,15370,Europe,42848,2012
23235,66083,4.2080625,United Kingdom,GBR,0,59.223,7865,15370,Europe,42848,2012
23235,66083,4.2080625,United Kingdom,GBR,0,59.223,7865,15370,Europe,42848,2012
23235,66083,4.2080625,United Kingdom,GBR,0,59.223,7865,15370,Europe,42848,2012
23235,66083,4.2080625,United Kingdom,GBR,0,59.223,7865,15370,Europe,42848,2012
2406,11559,4.436875000,Austria,AUT,0,80.387,244,2162,Europe,9153,2013
2406,11559,4.436875000,Austria,AUT,0,80.387,244,2162,Europe,9153,2013
2406,11559,4.436875000,Austria,AUT,0,80.387,244,2162,Europe,9153,2013
2406,11559,4.436875000,Austria,AUT,0,80.387,244,2162,Europe,9153,2013
2406,11559,4.436875000,Austria,AUT,0,80.387,244,2162,Europe,9153,2013
2406,11559,4.436875000,Austria,AUT,0,80.387,244,2162,Europe,9153,2013
2406,11559,4.436875000,Austria,AUT,0,80.387,244,2162,Europe,9153,2013
876,24940,4.1499375,Belgium,BEL,0,72.31,161,715,Europe,24064,2013
876,24940,4.1499375,Belgium,BEL,0,72.31,161,715,Europe,24064,2013
876,24940,4.1499375,Belgium,BEL,0,72.31,161,715,Europe,24064,2013
876,24940,4.1499375,Belgium,BEL,0,72.31,161,715,Europe,24064,2013
876,24940,4.1499375,Belgium,BEL,0,72.31,161,715,Europe,24064,2013
876,24940,4.1499375,Belgium,BEL,0,72.31,161,715,Europe,24064,2013
876,24940,4.1499375,Belgium,BEL,0,72.31,161,715,Europe,24064,2013
1534,6588,6.088500000,Denmark,DNK,0,81.237,193,1341,Europe,5054,2013
1534,6588,6.088500000,Denmark,DNK,0,81.237,193,1341,Europe,5054,2013
1534,6588,6.088500000,Denmark,DNK,0,81.237,193,1341,Europe,5054,2013
1534,6588,6.088500000,Denmark,DNK,0,81.237,193,1341,Europe,5054,2013
1534,6588,6.088500000,Denmark,DNK,0,81.237,193,1341,Europe,5054,2013
1534,6588,6.088500000,Denmark,DNK,0,81.237,193,1341,Europe,5054,2013
1534,6588,6.088500000,Denmark,DNK,0,81.237,193,1341,Europe,5054,2013
1737,7168,5.008875,Finland,FIN,0,91.066,141,1596,Europe,5431,2013
1737,7168,5.008875,Finland,FIN,0,91.066,141,1596,Europe,5431,2013
1737,7168,5.008875,Finland,FIN,0,91.066,141,1596,Europe,5431,2013
1737,7168,5.008875,Finland,FIN,0,91.066,141,1596,Europe,5431,2013
1737,7168,5.008875,Finland,FIN,0,91.066,141,1596,Europe,5431,2013
1737,7168,5.008875,Finland,FIN,0,91.066,141,1596,Europe,5431,2013
1737,7168,5.008875,Finland,FIN,0,91.066,141,1596,Europe,5431,2013
46,3647,5.359312500,Iceland,ISL,0,0,13,33,Europe,3601,2013
46,3647,5.359312500,Iceland,ISL,0,0,13,33,Europe,3601,2013
46,3647,5.359312500,Iceland,ISL,0,0,13,33,Europe,3601,2013
46,3647,5.359312500,Iceland,ISL,0,0,13,33,Europe,3601,2013
46,3647,5.359312500,Iceland,ISL,0,0,13,33,Europe,3601,2013
46,3647,5.359312500,Iceland,ISL,0,0,13,33,Europe,3601,2013
46,3647,5.359312500,Iceland,ISL,0,0,13,33,Europe,3601,2013
137,4352,8.6955,Lithuania,LTU,0,71.97,20,117,Europe,4215,2013
137,4352,8.6955,Lithuania,LTU,0,71.97,20,117,Europe,4215,2013
137,4352,8.6955,Lithuania,LTU,0,71.97,20,117,Europe,4215,2013
137,4352,8.6955,Lithuania,LTU,0,71.97,20,117,Europe,4215,2013
137,4352,8.6955,Lithuania,LTU,0,71.97,20,117,Europe,4215,2013
137,4352,8.6955,Lithuania,LTU,0,71.97,20,117,Europe,4215,2013
137,4352,8.6955,Lithuania,LTU,0,71.97,20,117,Europe,4215,2013
2764,2764,4.19025,Netherlands,NLD,0,0,449,2315,Europe,0,2013
2764,2764,4.19025,Netherlands,NLD,0,0,449,2315,Europe,0,2013
2764,2764,4.19025,Netherlands,NLD,0,0,449,2315,Europe,0,2013
2764,2764,4.19025,Netherlands,NLD,0,0,449,2315,Europe,0,2013
2764,2764,4.19025,Netherlands,NLD,0,0,449,2315,Europe,0,2013
2764,2764,4.19025,Netherlands,NLD,0,0,449,2315,Europe,0,2013
2764,2764,4.19025,Netherlands,NLD,0,0,449,2315,Europe,0,2013
1749,17022,5.5759375,Norway,NOR,0,76.118,648,1101,Europe,15273,2013
1749,17022,5.5759375,Norway,NOR,0,76.118,648,1101,Europe,15273,2013
1749,17022,5.5759375,Norway,NOR,0,76.118,648,1101,Europe,15273,2013
1749,17022,5.5759375,Norway,NOR,0,76.118,648,1101,Europe,15273,2013
1749,17022,5.5759375,Norway,NOR,0,76.118,648,1101,Europe,15273,2013
1749,17022,5.5759375,Norway,NOR,0,76.118,648,1101,Europe,15273,2013
1749,17022,5.5759375,Norway,NOR,0,76.118,648,1101,Europe,15273,2013
0,1700,4.1545625,Slovenia,SVN,0,85.222,0,0,Europe,1700,2013
0,1700,4.1545625,Slovenia,SVN,0,85.222,0,0,Europe,1700,2013
0,1700,4.1545625,Slovenia,SVN,0,85.222,0,0,Europe,1700,2013
0,1700,4.1545625,Slovenia,SVN,0,85.222,0,0,Europe,1700,2013
0,1700,4.1545625,Slovenia,SVN,0,85.222,0,0,Europe,1700,2013
0,1700,4.1545625,Slovenia,SVN,0,85.222,0,0,Europe,1700,2013
0,1700,4.1545625,Slovenia,SVN,0,85.222,0,0,Europe,1700,2013
2495,13201,5.4556875,Sweden,SWE,0,63.393,163,2332,Europe,10706,2013
2495,13201,5.4556875,Sweden,SWE,0,63.393,163,2332,Europe,10706,2013
2495,13201,5.4556875,Sweden,SWE,0,63.393,163,2332,Europe,10706,2013
2495,13201,5.4556875,Sweden,SWE,0,63.393,163,2332,Europe,10706,2013
2495,13201,5.4556875,Sweden,SWE,0,63.393,163,2332,Europe,10706,2013
2495,13201,5.4556875,Sweden,SWE,0,63.393,163,2332,Europe,10706,2013
2495,13201,5.4556875,Sweden,SWE,0,63.393,163,2332,Europe,10706,2013
5412,39494,6.672,Ukraine,UKR,6.672,80.071,2556,2856,Europe,34082,2013
5412,39494,6.672,Ukraine,UKR,6.672,80.071,2556,2856,Europe,34082,2013
5412,39494,6.672,Ukraine,UKR,6.672,80.071,2556,2856,Europe,34082,2013
5412,39494,6.672,Ukraine,UKR,6.672,80.071,2556,2856,Europe,34082,2013
5412,39494,6.672,Ukraine,UKR,6.672,80.071,2556,2856,Europe,34082,2013
5412,39494,6.672,Ukraine,UKR,6.672,80.071,2556,2856,Europe,34082,2013
5412,39494,6.672,Ukraine,UKR,6.672,80.071,2556,2856,Europe,34082,2013
22938,73353,5.72,United Kingdom,GBR,5.72,56.87,7966,14972,Europe,50415,2013
22938,73353,5.72,United Kingdom,GBR,5.72,56.87,7966,14972,Europe,50415,2013
22938,73353,5.72,United Kingdom,GBR,5.72,56.87,7966,14972,Europe,50415,2013
22938,73353,5.72,United Kingdom,GBR,5.72,56.87,7966,14972,Europe,50415,2013
22938,73353,5.72,United Kingdom,GBR,5.72,56.87,7966,14972,Europe,50415,2013
22938,73353,5.72,United Kingdom,GBR,5.72,56.87,7966,14972,Europe,50415,2013
22938,73353,5.72,United Kingdom,GBR,5.72,56.87,7966,14972,Europe,50415,2013
2363,11033,4.436875000,Austria,AUT,0,79.999,271,2092,Europe,8670,2014
2363,11033,4.436875000,Austria,AUT,0,79.999,271,2092,Europe,8670,2014
2363,11033,4.436875000,Austria,AUT,0,79.999,271,2092,Europe,8670,2014
2363,11033,4.436875000,Austria,AUT,0,79.999,271,2092,Europe,8670,2014
2363,11033,4.436875000,Austria,AUT,0,79.999,271,2092,Europe,8670,2014
2363,11033,4.436875000,Austria,AUT,0,79.999,271,2092,Europe,8670,2014
2363,11033,4.436875000,Austria,AUT,0,79.999,271,2092,Europe,8670,2014
1026,24059,4.1499375,Belgium,BEL,0,0,137,889,Europe,23033,2014
1026,24059,4.1499375,Belgium,BEL,0,0,137,889,Europe,23033,2014
1026,24059,4.1499375,Belgium,BEL,0,0,137,889,Europe,23033,2014
1026,24059,4.1499375,Belgium,BEL,0,0,137,889,Europe,23033,2014
1026,24059,4.1499375,Belgium,BEL,0,0,137,889,Europe,23033,2014
1026,24059,4.1499375,Belgium,BEL,0,0,137,889,Europe,23033,2014
1026,24059,4.1499375,Belgium,BEL,0,0,137,889,Europe,23033,2014
1583,6060,6.088500000,Denmark,DNK,0,0,206,1377,Europe,4477,2014
1583,6060,6.088500000,Denmark,DNK,0,0,206,1377,Europe,4477,2014
1583,6060,6.088500000,Denmark,DNK,0,0,206,1377,Europe,4477,2014
1583,6060,6.088500000,Denmark,DNK,0,0,206,1377,Europe,4477,2014
1583,6060,6.088500000,Denmark,DNK,0,0,206,1377,Europe,4477,2014
1583,6060,6.088500000,Denmark,DNK,0,0,206,1377,Europe,4477,2014
1583,6060,6.088500000,Denmark,DNK,0,0,206,1377,Europe,4477,2014
1545,6097,5.008875,Finland,FIN,0,0,126,1419,Europe,4552,2014
1545,6097,5.008875,Finland,FIN,0,0,126,1419,Europe,4552,2014
1545,6097,5.008875,Finland,FIN,0,0,126,1419,Europe,4552,2014
1545,6097,5.008875,Finland,FIN,0,0,126,1419,Europe,4552,2014
1545,6097,5.008875,Finland,FIN,0,0,126,1419,Europe,4552,2014
1545,6097,5.008875,Finland,FIN,0,0,126,1419,Europe,4552,2014
1545,6097,5.008875,Finland,FIN,0,0,126,1419,Europe,4552,2014
64,3799,5.359312500,Iceland,ISL,0,0,13,51,Europe,3735,2014
64,3799,5.359312500,Iceland,ISL,0,0,13,51,Europe,3735,2014
64,3799,5.359312500,Iceland,ISL,0,0,13,51,Europe,3735,2014
64,3799,5.359312500,Iceland,ISL,0,0,13,51,Europe,3735,2014
64,3799,5.359312500,Iceland,ISL,0,0,13,51,Europe,3735,2014
64,3799,5.359312500,Iceland,ISL,0,0,13,51,Europe,3735,2014
64,3799,5.359312500,Iceland,ISL,0,0,13,51,Europe,3735,2014
165,4270,8.6955,Lithuania,LTU,0,0,42,123,Europe,4105,2014
165,4270,8.6955,Lithuania,LTU,0,0,42,123,Europe,4105,2014
165,4270,8.6955,Lithuania,LTU,0,0,42,123,Europe,4105,2014
165,4270,8.6955,Lithuania,LTU,0,0,42,123,Europe,4105,2014
165,4270,8.6955,Lithuania,LTU,0,0,42,123,Europe,4105,2014
165,4270,8.6955,Lithuania,LTU,0,0,42,123,Europe,4105,2014
165,4270,8.6955,Lithuania,LTU,0,0,42,123,Europe,4105,2014
2582,2582,4.19025,Netherlands,NLD,0,0,288,2294,Europe,0,2014
2582,2582,4.19025,Netherlands,NLD,0,0,288,2294,Europe,0,2014
2582,2582,4.19025,Netherlands,NLD,0,0,288,2294,Europe,0,2014
2582,2582,4.19025,Netherlands,NLD,0,0,288,2294,Europe,0,2014
2582,2582,4.19025,Netherlands,NLD,0,0,288,2294,Europe,0,2014
2582,2582,4.19025,Netherlands,NLD,0,0,288,2294,Europe,0,2014
2582,2582,4.19025,Netherlands,NLD,0,0,288,2294,Europe,0,2014
1563,17038,5.5759375,Norway,NOR,0,0,457,1106,Europe,15475,2014
1563,17038,5.5759375,Norway,NOR,0,0,457,1106,Europe,15475,2014
1563,17038,5.5759375,Norway,NOR,0,0,457,1106,Europe,15475,2014
1563,17038,5.5759375,Norway,NOR,0,0,457,1106,Europe,15475,2014
1563,17038,5.5759375,Norway,NOR,0,0,457,1106,Europe,15475,2014
1563,17038,5.5759375,Norway,NOR,0,0,457,1106,Europe,15475,2014
1563,17038,5.5759375,Norway,NOR,0,0,457,1106,Europe,15475,2014
0,1402,4.1545625,Slovenia,SVN,0,0,0,0,Europe,1402,2014
0,1402,4.1545625,Slovenia,SVN,0,0,0,0,Europe,1402,2014
0,1402,4.1545625,Slovenia,SVN,0,0,0,0,Europe,1402,2014
0,1402,4.1545625,Slovenia,SVN,0,0,0,0,Europe,1402,2014
0,1402,4.1545625,Slovenia,SVN,0,0,0,0,Europe,1402,2014
0,1402,4.1545625,Slovenia,SVN,0,0,0,0,Europe,1402,2014
0,1402,4.1545625,Slovenia,SVN,0,0,0,0,Europe,1402,2014
2425,12352,5.4556875,Sweden,SWE,0,0,441,1984,Europe,9927,2014
2425,12352,5.4556875,Sweden,SWE,0,0,441,1984,Europe,9927,2014
2425,12352,5.4556875,Sweden,SWE,0,0,441,1984,Europe,9927,2014
2425,12352,5.4556875,Sweden,SWE,0,0,441,1984,Europe,9927,2014
2425,12352,5.4556875,Sweden,SWE,0,0,441,1984,Europe,9927,2014
2425,12352,5.4556875,Sweden,SWE,0,0,441,1984,Europe,9927,2014
2425,12352,5.4556875,Sweden,SWE,0,0,441,1984,Europe,9927,2014
4813,32055,4.804625,Ukraine,UKR,0,82.305,2356,2457,Europe,27242,2014
4813,32055,4.804625,Ukraine,UKR,0,82.305,2356,2457,Europe,27242,2014
4813,32055,4.804625,Ukraine,UKR,0,82.305,2356,2457,Europe,27242,2014
4813,32055,4.804625,Ukraine,UKR,0,82.305,2356,2457,Europe,27242,2014
4813,32055,4.804625,Ukraine,UKR,0,82.305,2356,2457,Europe,27242,2014
4813,32055,4.804625,Ukraine,UKR,0,82.305,2356,2457,Europe,27242,2014
4813,32055,4.804625,Ukraine,UKR,0,82.305,2356,2457,Europe,27242,2014
23040,77565,4.2080625,United Kingdom,GBR,0,0,7844,15196,Europe,54525,2014
23040,77565,4.2080625,United Kingdom,GBR,0,0,7844,15196,Europe,54525,2014
23040,77565,4.2080625,United Kingdom,GBR,0,0,7844,15196,Europe,54525,2014
23040,77565,4.2080625,United Kingdom,GBR,0,0,7844,15196,Europe,54525,2014
23040,77565,4.2080625,United Kingdom,GBR,0,0,7844,15196,Europe,54525,2014
23040,77565,4.2080625,United Kingdom,GBR,0,0,7844,15196,Europe,54525,2014
23040,77565,4.2080625,United Kingdom,GBR,0,0,7844,15196,Europe,54525,2014
0,0,4.436875000,Austria,AUT,0,0,0,0,Europe,0,2015
0,0,4.436875000,Austria,AUT,0,0,0,0,Europe,0,2015
0,0,4.436875000,Austria,AUT,0,0,0,0,Europe,0,2015
0,0,4.436875000,Austria,AUT,0,0,0,0,Europe,0,2015
0,0,4.436875000,Austria,AUT,0,0,0,0,Europe,0,2015
0,0,4.436875000,Austria,AUT,0,0,0,0,Europe,0,2015
0,0,4.436875000,Austria,AUT,0,0,0,0,Europe,0,2015
0,0,4.1499375,Belgium,BEL,0,0,0,0,Europe,0,2015
0,0,4.1499375,Belgium,BEL,0,0,0,0,Europe,0,2015
0,0,4.1499375,Belgium,BEL,0,0,0,0,Europe,0,2015
0,0,4.1499375,Belgium,BEL,0,0,0,0,Europe,0,2015
0,0,4.1499375,Belgium,BEL,0,0,0,0,Europe,0,2015
0,0,4.1499375,Belgium,BEL,0,0,0,0,Europe,0,2015
0,0,4.1499375,Belgium,BEL,0,0,0,0,Europe,0,2015
0,0,6.088500000,Denmark,DNK,0,0,0,0,Europe,0,2015
0,0,6.088500000,Denmark,DNK,0,0,0,0,Europe,0,2015
0,0,6.088500000,Denmark,DNK,0,0,0,0,Europe,0,2015
0,0,6.088500000,Denmark,DNK,0,0,0,0,Europe,0,2015
0,0,6.088500000,Denmark,DNK,0,0,0,0,Europe,0,2015
0,0,6.088500000,Denmark,DNK,0,0,0,0,Europe,0,2015
0,0,6.088500000,Denmark,DNK,0,0,0,0,Europe,0,2015
0,0,5.008875,Finland,FIN,0,0,0,0,Europe,0,2015
0,0,5.008875,Finland,FIN,0,0,0,0,Europe,0,2015
0,0,5.008875,Finland,FIN,0,0,0,0,Europe,0,2015
0,0,5.008875,Finland,FIN,0,0,0,0,Europe,0,2015
0,0,5.008875,Finland,FIN,0,0,0,0,Europe,0,2015
0,0,5.008875,Finland,FIN,0,0,0,0,Europe,0,2015
0,0,5.008875,Finland,FIN,0,0,0,0,Europe,0,2015
0,0,5.359312500,Iceland,ISL,0,0,0,0,Europe,0,2015
0,0,5.359312500,Iceland,ISL,0,0,0,0,Europe,0,2015
0,0,5.359312500,Iceland,ISL,0,0,0,0,Europe,0,2015
0,0,5.359312500,Iceland,ISL,0,0,0,0,Europe,0,2015
0,0,5.359312500,Iceland,ISL,0,0,0,0,Europe,0,2015
0,0,5.359312500,Iceland,ISL,0,0,0,0,Europe,0,2015
0,0,5.359312500,Iceland,ISL,0,0,0,0,Europe,0,2015
0,0,8.6955,Lithuania,LTU,0,0,0,0,Europe,0,2015
0,0,8.6955,Lithuania,LTU,0,0,0,0,Europe,0,2015
0,0,8.6955,Lithuania,LTU,0,0,0,0,Europe,0,2015
0,0,8.6955,Lithuania,LTU,0,0,0,0,Europe,0,2015
0,0,8.6955,Lithuania,LTU,0,0,0,0,Europe,0,2015
0,0,8.6955,Lithuania,LTU,0,0,0,0,Europe,0,2015
0,0,8.6955,Lithuania,LTU,0,0,0,0,Europe,0,2015
0,0,4.19025,Netherlands,NLD,0,0,0,0,Europe,0,2015
0,0,4.19025,Netherlands,NLD,0,0,0,0,Europe,0,2015
0,0,4.19025,Netherlands,NLD,0,0,0,0,Europe,0,2015
0,0,4.19025,Netherlands,NLD,0,0,0,0,Europe,0,2015
0,0,4.19025,Netherlands,NLD,0,0,0,0,Europe,0,2015
0,0,4.19025,Netherlands,NLD,0,0,0,0,Europe,0,2015
0,0,4.19025,Netherlands,NLD,0,0,0,0,Europe,0,2015
0,0,5.5759375,Norway,NOR,0,0,0,0,Europe,0,2015
0,0,5.5759375,Norway,NOR,0,0,0,0,Europe,0,2015
0,0,5.5759375,Norway,NOR,0,0,0,0,Europe,0,2015
0,0,5.5759375,Norway,NOR,0,0,0,0,Europe,0,2015
0,0,5.5759375,Norway,NOR,0,0,0,0,Europe,0,2015
0,0,5.5759375,Norway,NOR,0,0,0,0,Europe,0,2015
0,0,5.5759375,Norway,NOR,0,0,0,0,Europe,0,2015
0,0,4.1545625,Slovenia,SVN,0,0,0,0,Europe,0,2015
0,0,4.1545625,Slovenia,SVN,0,0,0,0,Europe,0,2015
0,0,4.1545625,Slovenia,SVN,0,0,0,0,Europe,0,2015
0,0,4.1545625,Slovenia,SVN,0,0,0,0,Europe,0,2015
0,0,4.1545625,Slovenia,SVN,0,0,0,0,Europe,0,2015
0,0,4.1545625,Slovenia,SVN,0,0,0,0,Europe,0,2015
0,0,4.1545625,Slovenia,SVN,0,0,0,0,Europe,0,2015
0,0,5.4556875,Sweden,SWE,0,0,0,0,Europe,0,2015
0,0,5.4556875,Sweden,SWE,0,0,0,0,Europe,0,2015
0,0,5.4556875,Sweden,SWE,0,0,0,0,Europe,0,2015
0,0,5.4556875,Sweden,SWE,0,0,0,0,Europe,0,2015
0,0,5.4556875,Sweden,SWE,0,0,0,0,Europe,0,2015
0,0,5.4556875,Sweden,SWE,0,0,0,0,Europe,0,2015
0,0,5.4556875,Sweden,SWE,0,0,0,0,Europe,0,2015
0,0,4.804625,Ukraine,UKR,0,0,0,0,Europe,0,2015
0,0,4.804625,Ukraine,UKR,0,0,0,0,Europe,0,2015
0,0,4.804625,Ukraine,UKR,0,0,0,0,Europe,0,2015
0,0,4.804625,Ukraine,UKR,0,0,0,0,Europe,0,2015
0,0,4.804625,Ukraine,UKR,0,0,0,0,Europe,0,2015
0,0,4.804625,Ukraine,UKR,0,0,0,0,Europe,0,2015
0,0,4.804625,Ukraine,UKR,0,0,0,0,Europe,0,2015
0,0,4.2080625,United Kingdom,GBR,0,0,0,0,Europe,0,2015
0,0,4.2080625,United Kingdom,GBR,0,0,0,0,Europe,0,2015
0,0,4.2080625,United Kingdom,GBR,0,0,0,0,Europe,0,2015
0,0,4.2080625,United Kingdom,GBR,0,0,0,0,Europe,0,2015
0,0,4.2080625,United Kingdom,GBR,0,0,0,0,Europe,0,2015
0,0,4.2080625,United Kingdom,GBR,0,0,0,0,Europe,0,2015
0,0,4.2080625,United Kingdom,GBR,0,0,0,0,Europe,0,2015
0,4003,7.705,Cuba,CUB,7.705,22.363,0,0,Latin America & the Caribbean,4003,2000
0,4003,7.705,Cuba,CUB,7.705,22.363,0,0,Latin America & the Caribbean,4003,2000
0,4003,7.705,Cuba,CUB,7.705,22.363,0,0,Latin America & the Caribbean,4003,2000
0,4003,7.705,Cuba,CUB,7.705,22.363,0,0,Latin America & the Caribbean,4003,2000
0,4003,7.705,Cuba,CUB,7.705,22.363,0,0,Latin America & the Caribbean,4003,2000
0,4003,7.705,Cuba,CUB,7.705,22.363,0,0,Latin America & the Caribbean,4003,2000
0,4003,7.705,Cuba,CUB,7.705,22.363,0,0,Latin America & the Caribbean,4003,2000
0,3199,8.358,Cuba,CUB,8.358,25.58,0,0,Latin America & the Caribbean,3199,2001
0,3199,8.358,Cuba,CUB,8.358,25.58,0,0,Latin America & the Caribbean,3199,2001
0,3199,8.358,Cuba,CUB,8.358,25.58,0,0,Latin America & the Caribbean,3199,2001
0,3199,8.358,Cuba,CUB,8.358,25.58,0,0,Latin America & the Caribbean,3199,2001
0,3199,8.358,Cuba,CUB,8.358,25.58,0,0,Latin America & the Caribbean,3199,2001
0,3199,8.358,Cuba,CUB,8.358,25.58,0,0,Latin America & the Caribbean,3199,2001
0,3199,8.358,Cuba,CUB,8.358,25.58,0,0,Latin America & the Caribbean,3199,2001
0,2665,9.571,Cuba,CUB,9.571,27.353,0,0,Latin America & the Caribbean,2665,2002
0,2665,9.571,Cuba,CUB,9.571,27.353,0,0,Latin America & the Caribbean,2665,2002
0,2665,9.571,Cuba,CUB,9.571,27.353,0,0,Latin America & the Caribbean,2665,2002
0,2665,9.571,Cuba,CUB,9.571,27.353,0,0,Latin America & the Caribbean,2665,2002
0,2665,9.571,Cuba,CUB,9.571,27.353,0,0,Latin America & the Caribbean,2665,2002
0,2665,9.571,Cuba,CUB,9.571,27.353,0,0,Latin America & the Caribbean,2665,2002
0,2665,9.571,Cuba,CUB,9.571,27.353,0,0,Latin America & the Caribbean,2665,2002
0,2391,9.941,Cuba,CUB,9.941,33.145,0,0,Latin America & the Caribbean,2391,2003
0,2391,9.941,Cuba,CUB,9.941,33.145,0,0,Latin America & the Caribbean,2391,2003
0,2391,9.941,Cuba,CUB,9.941,33.145,0,0,Latin America & the Caribbean,2391,2003
0,2391,9.941,Cuba,CUB,9.941,33.145,0,0,Latin America & the Caribbean,2391,2003
0,2391,9.941,Cuba,CUB,9.941,33.145,0,0,Latin America & the Caribbean,2391,2003
0,2391,9.941,Cuba,CUB,9.941,33.145,0,0,Latin America & the Caribbean,2391,2003
0,2391,9.941,Cuba,CUB,9.941,33.145,0,0,Latin America & the Caribbean,2391,2003
0,2332,10.268,Cuba,CUB,10.268,54.395,0,0,Latin America & the Caribbean,2332,2004
0,2332,10.268,Cuba,CUB,10.268,54.395,0,0,Latin America & the Caribbean,2332,2004
0,2332,10.268,Cuba,CUB,10.268,54.395,0,0,Latin America & the Caribbean,2332,2004
0,2332,10.268,Cuba,CUB,10.268,54.395,0,0,Latin America & the Caribbean,2332,2004
0,2332,10.268,Cuba,CUB,10.268,54.395,0,0,Latin America & the Caribbean,2332,2004
0,2332,10.268,Cuba,CUB,10.268,54.395,0,0,Latin America & the Caribbean,2332,2004
0,2332,10.268,Cuba,CUB,10.268,54.395,0,0,Latin America & the Caribbean,2332,2004
285,2920,10.558,Cuba,CUB,10.558,62.864,180,105,Latin America & the Caribbean,2635,2005
285,2920,10.558,Cuba,CUB,10.558,62.864,180,105,Latin America & the Caribbean,2635,2005
285,2920,10.558,Cuba,CUB,10.558,62.864,180,105,Latin America & the Caribbean,2635,2005
285,2920,10.558,Cuba,CUB,10.558,62.864,180,105,Latin America & the Caribbean,2635,2005
285,2920,10.558,Cuba,CUB,10.558,62.864,180,105,Latin America & the Caribbean,2635,2005
285,2920,10.558,Cuba,CUB,10.558,62.864,180,105,Latin America & the Caribbean,2635,2005
285,2920,10.558,Cuba,CUB,10.558,62.864,180,105,Latin America & the Caribbean,2635,2005
257,2891,9.057,Cuba,CUB,9.057,87.652,163,94,Latin America & the Caribbean,2634,2006
257,2891,9.057,Cuba,CUB,9.057,87.652,163,94,Latin America & the Caribbean,2634,2006
257,2891,9.057,Cuba,CUB,9.057,87.652,163,94,Latin America & the Caribbean,2634,2006
257,2891,9.057,Cuba,CUB,9.057,87.652,163,94,Latin America & the Caribbean,2634,2006
257,2891,9.057,Cuba,CUB,9.057,87.652,163,94,Latin America & the Caribbean,2634,2006
257,2891,9.057,Cuba,CUB,9.057,87.652,163,94,Latin America & the Caribbean,2634,2006
257,2891,9.057,Cuba,CUB,9.057,87.652,163,94,Latin America & the Caribbean,2634,2006
284,2691,11.868,Cuba,CUB,11.868,107.447,210,74,Latin America & the Caribbean,2407,2007
284,2691,11.868,Cuba,CUB,11.868,107.447,210,74,Latin America & the Caribbean,2407,2007
284,2691,11.868,Cuba,CUB,11.868,107.447,210,74,Latin America & the Caribbean,2407,2007
284,2691,11.868,Cuba,CUB,11.868,107.447,210,74,Latin America & the Caribbean,2407,2007
284,2691,11.868,Cuba,CUB,11.868,107.447,210,74,Latin America & the Caribbean,2407,2007
284,2691,11.868,Cuba,CUB,11.868,107.447,210,74,Latin America & the Caribbean,2407,2007
284,2691,11.868,Cuba,CUB,11.868,107.447,210,74,Latin America & the Caribbean,2407,2007
258,2798,14.059,Cuba,CUB,14.059,119.779,189,69,Latin America & the Caribbean,2540,2008
258,2798,14.059,Cuba,CUB,14.059,119.779,189,69,Latin America & the Caribbean,2540,2008
258,2798,14.059,Cuba,CUB,14.059,119.779,189,69,Latin America & the Caribbean,2540,2008
258,2798,14.059,Cuba,CUB,14.059,119.779,189,69,Latin America & the Caribbean,2540,2008
258,2798,14.059,Cuba,CUB,14.059,119.779,189,69,Latin America & the Caribbean,2540,2008
258,2798,14.059,Cuba,CUB,14.059,119.779,189,69,Latin America & the Caribbean,2540,2008
258,2798,14.059,Cuba,CUB,14.059,119.779,189,69,Latin America & the Caribbean,2540,2008
231,2273,13.125,Cuba,CUB,13.125,116.855,172,59,Latin America & the Caribbean,2042,2009
231,2273,13.125,Cuba,CUB,13.125,116.855,172,59,Latin America & the Caribbean,2042,2009
231,2273,13.125,Cuba,CUB,13.125,116.855,172,59,Latin America & the Caribbean,2042,2009
231,2273,13.125,Cuba,CUB,13.125,116.855,172,59,Latin America & the Caribbean,2042,2009
231,2273,13.125,Cuba,CUB,13.125,116.855,172,59,Latin America & the Caribbean,2042,2009
231,2273,13.125,Cuba,CUB,13.125,116.855,172,59,Latin America & the Caribbean,2042,2009
231,2273,13.125,Cuba,CUB,13.125,116.855,172,59,Latin America & the Caribbean,2042,2009
0,1389,12.837,Cuba,CUB,12.837,97.058,0,0,Latin America & the Caribbean,1389,2010
0,1389,12.837,Cuba,CUB,12.837,97.058,0,0,Latin America & the Caribbean,1389,2010
0,1389,12.837,Cuba,CUB,12.837,97.058,0,0,Latin America & the Caribbean,1389,2010
0,1389,12.837,Cuba,CUB,12.837,97.058,0,0,Latin America & the Caribbean,1389,2010
0,1389,12.837,Cuba,CUB,12.837,97.058,0,0,Latin America & the Caribbean,1389,2010
0,1389,12.837,Cuba,CUB,12.837,97.058,0,0,Latin America & the Caribbean,1389,2010
0,1389,12.837,Cuba,CUB,12.837,97.058,0,0,Latin America & the Caribbean,1389,2010
246,2287,7.3341875,Cuba,CUB,0,82.497,184,62,Latin America & the Caribbean,2041,2011
246,2287,7.3341875,Cuba,CUB,0,82.497,184,62,Latin America & the Caribbean,2041,2011
246,2287,7.3341875,Cuba,CUB,0,82.497,184,62,Latin America & the Caribbean,2041,2011
246,2287,7.3341875,Cuba,CUB,0,82.497,184,62,Latin America & the Caribbean,2041,2011
246,2287,7.3341875,Cuba,CUB,0,82.497,184,62,Latin America & the Caribbean,2041,2011
246,2287,7.3341875,Cuba,CUB,0,82.497,184,62,Latin America & the Caribbean,2041,2011
246,2287,7.3341875,Cuba,CUB,0,82.497,184,62,Latin America & the Caribbean,2041,2011
178,2917,7.3341875,Cuba,CUB,0,64.453,140,38,Latin America & the Caribbean,2739,2012
178,2917,7.3341875,Cuba,CUB,0,64.453,140,38,Latin America & the Caribbean,2739,2012
178,2917,7.3341875,Cuba,CUB,0,64.453,140,38,Latin America & the Caribbean,2739,2012
178,2917,7.3341875,Cuba,CUB,0,64.453,140,38,Latin America & the Caribbean,2739,2012
178,2917,7.3341875,Cuba,CUB,0,64.453,140,38,Latin America & the Caribbean,2739,2012
178,2917,7.3341875,Cuba,CUB,0,64.453,140,38,Latin America & the Caribbean,2739,2012
178,2917,7.3341875,Cuba,CUB,0,64.453,140,38,Latin America & the Caribbean,2739,2012
170,2471,7.3341875,Cuba,CUB,0,49.4,143,27,Latin America & the Caribbean,2301,2013
170,2471,7.3341875,Cuba,CUB,0,49.4,143,27,Latin America & the Caribbean,2301,2013
170,2471,7.3341875,Cuba,CUB,0,49.4,143,27,Latin America & the Caribbean,2301,2013
170,2471,7.3341875,Cuba,CUB,0,49.4,143,27,Latin America & the Caribbean,2301,2013
170,2471,7.3341875,Cuba,CUB,0,49.4,143,27,Latin America & the Caribbean,2301,2013
170,2471,7.3341875,Cuba,CUB,0,49.4,143,27,Latin America & the Caribbean,2301,2013
170,2471,7.3341875,Cuba,CUB,0,49.4,143,27,Latin America & the Caribbean,2301,2013
150,2575,7.3341875,Cuba,CUB,0,41,126,24,Latin America & the Caribbean,2425,2014
150,2575,7.3341875,Cuba,CUB,0,41,126,24,Latin America & the Caribbean,2425,2014
150,2575,7.3341875,Cuba,CUB,0,41,126,24,Latin America & the Caribbean,2425,2014
150,2575,7.3341875,Cuba,CUB,0,41,126,24,Latin America & the Caribbean,2425,2014
150,2575,7.3341875,Cuba,CUB,0,41,126,24,Latin America & the Caribbean,2425,2014
150,2575,7.3341875,Cuba,CUB,0,41,126,24,Latin America & the Caribbean,2425,2014
150,2575,7.3341875,Cuba,CUB,0,41,126,24,Latin America & the Caribbean,2425,2014
0,0,7.3341875,Cuba,CUB,0,0,0,0,Latin America & the Caribbean,0,2015
0,0,7.3341875,Cuba,CUB,0,0,0,0,Latin America & the Caribbean,0,2015
0,0,7.3341875,Cuba,CUB,0,0,0,0,Latin America & the Caribbean,0,2015
0,0,7.3341875,Cuba,CUB,0,0,0,0,Latin America & the Caribbean,0,2015
0,0,7.3341875,Cuba,CUB,0,0,0,0,Latin America & the Caribbean,0,2015
0,0,7.3341875,Cuba,CUB,0,0,0,0,Latin America & the Caribbean,0,2015
0,0,7.3341875,Cuba,CUB,0,0,0,0,Latin America & the Caribbean,0,2015
7048,31094,4.825500000,New Zealand,NZL,0,66.192,5585,1463,Oceania,24046,2000
7048,31094,4.825500000,New Zealand,NZL,0,66.192,5585,1463,Oceania,24046,2000
7048,31094,4.825500000,New Zealand,NZL,0,66.192,5585,1463,Oceania,24046,2000
7048,31094,4.825500000,New Zealand,NZL,0,66.192,5585,1463,Oceania,24046,2000
7048,31094,4.825500000,New Zealand,NZL,0,66.192,5585,1463,Oceania,24046,2000
7048,31094,4.825500000,New Zealand,NZL,0,66.192,5585,1463,Oceania,24046,2000
7048,31094,4.825500000,New Zealand,NZL,0,66.192,5585,1463,Oceania,24046,2000
7275,27889,6.561,New Zealand,NZL,6.561,66.593,5507,1768,Oceania,20614,2001
7275,27889,6.561,New Zealand,NZL,6.561,66.593,5507,1768,Oceania,20614,2001
7275,27889,6.561,New Zealand,NZL,6.561,66.593,5507,1768,Oceania,20614,2001
7275,27889,6.561,New Zealand,NZL,6.561,66.593,5507,1768,Oceania,20614,2001
7275,27889,6.561,New Zealand,NZL,6.561,66.593,5507,1768,Oceania,20614,2001
7275,27889,6.561,New Zealand,NZL,6.561,66.593,5507,1768,Oceania,20614,2001
7275,27889,6.561,New Zealand,NZL,6.561,66.593,5507,1768,Oceania,20614,2001
6948,27042,6.407,New Zealand,NZL,6.407,67.277,5109,1839,Oceania,20094,2002
6948,27042,6.407,New Zealand,NZL,6.407,67.277,5109,1839,Oceania,20094,2002
6948,27042,6.407,New Zealand,NZL,6.407,67.277,5109,1839,Oceania,20094,2002
6948,27042,6.407,New Zealand,NZL,6.407,67.277,5109,1839,Oceania,20094,2002
6948,27042,6.407,New Zealand,NZL,6.407,67.277,5109,1839,Oceania,20094,2002
6948,27042,6.407,New Zealand,NZL,6.407,67.277,5109,1839,Oceania,20094,2002
6948,27042,6.407,New Zealand,NZL,6.407,67.277,5109,1839,Oceania,20094,2002
6873,30092,6.429,New Zealand,NZL,6.429,68.98,5028,1845,Oceania,23219,2003
6873,30092,6.429,New Zealand,NZL,6.429,68.98,5028,1845,Oceania,23219,2003
6873,30092,6.429,New Zealand,NZL,6.429,68.98,5028,1845,Oceania,23219,2003
6873,30092,6.429,New Zealand,NZL,6.429,68.98,5028,1845,Oceania,23219,2003
6873,30092,6.429,New Zealand,NZL,6.429,68.98,5028,1845,Oceania,23219,2003
6873,30092,6.429,New Zealand,NZL,6.429,68.98,5028,1845,Oceania,23219,2003
6873,30092,6.429,New Zealand,NZL,6.429,68.98,5028,1845,Oceania,23219,2003
6531,22821,6.504,New Zealand,NZL,6.504,83.601,4900,1631,Oceania,16290,2004
6531,22821,6.504,New Zealand,NZL,6.504,83.601,4900,1631,Oceania,16290,2004
6531,22821,6.504,New Zealand,NZL,6.504,83.601,4900,1631,Oceania,16290,2004
6531,22821,6.504,New Zealand,NZL,6.504,83.601,4900,1631,Oceania,16290,2004
6531,22821,6.504,New Zealand,NZL,6.504,83.601,4900,1631,Oceania,16290,2004
6531,22821,6.504,New Zealand,NZL,6.504,83.601,4900,1631,Oceania,16290,2004
6531,22821,6.504,New Zealand,NZL,6.504,83.601,4900,1631,Oceania,16290,2004
7005,23838,6.269,New Zealand,NZL,6.269,80.642,5112,1893,Oceania,16833,2005
7005,23838,6.269,New Zealand,NZL,6.269,80.642,5112,1893,Oceania,16833,2005
7005,23838,6.269,New Zealand,NZL,6.269,80.642,5112,1893,Oceania,16833,2005
7005,23838,6.269,New Zealand,NZL,6.269,80.642,5112,1893,Oceania,16833,2005
7005,23838,6.269,New Zealand,NZL,6.269,80.642,5112,1893,Oceania,16833,2005
7005,23838,6.269,New Zealand,NZL,6.269,80.642,5112,1893,Oceania,16833,2005
7005,23838,6.269,New Zealand,NZL,6.269,80.642,5112,1893,Oceania,16833,2005
7365,26191,5.935,New Zealand,NZL,5.935,78.684,5212,2153,Oceania,18826,2006
7365,26191,5.935,New Zealand,NZL,5.935,78.684,5212,2153,Oceania,18826,2006
7365,26191,5.935,New Zealand,NZL,5.935,78.684,5212,2153,Oceania,18826,2006
7365,26191,5.935,New Zealand,NZL,5.935,78.684,5212,2153,Oceania,18826,2006
7365,26191,5.935,New Zealand,NZL,5.935,78.684,5212,2153,Oceania,18826,2006
7365,26191,5.935,New Zealand,NZL,5.935,78.684,5212,2153,Oceania,18826,2006
7365,26191,5.935,New Zealand,NZL,5.935,78.684,5212,2153,Oceania,18826,2006
7844,27454,5.925,New Zealand,NZL,5.925,78.92,5952,1892,Oceania,19610,2007
7844,27454,5.925,New Zealand,NZL,5.925,78.92,5952,1892,Oceania,19610,2007
7844,27454,5.925,New Zealand,NZL,5.925,78.92,5952,1892,Oceania,19610,2007
7844,27454,5.925,New Zealand,NZL,5.925,78.92,5952,1892,Oceania,19610,2007
7844,27454,5.925,New Zealand,NZL,5.925,78.92,5952,1892,Oceania,19610,2007
7844,27454,5.925,New Zealand,NZL,5.925,78.92,5952,1892,Oceania,19610,2007
7844,27454,5.925,New Zealand,NZL,5.925,78.92,5952,1892,Oceania,19610,2007
5724,23306,5.528,New Zealand,NZL,5.528,78.032,4468,1256,Oceania,17582,2008
5724,23306,5.528,New Zealand,NZL,5.528,78.032,4468,1256,Oceania,17582,2008
5724,23306,5.528,New Zealand,NZL,5.528,78.032,4468,1256,Oceania,17582,2008
5724,23306,5.528,New Zealand,NZL,5.528,78.032,4468,1256,Oceania,17582,2008
5724,23306,5.528,New Zealand,NZL,5.528,78.032,4468,1256,Oceania,17582,2008
5724,23306,5.528,New Zealand,NZL,5.528,78.032,4468,1256,Oceania,17582,2008
5724,23306,5.528,New Zealand,NZL,5.528,78.032,4468,1256,Oceania,17582,2008
6358,22548,6.345,New Zealand,NZL,6.345,82.604,4803,1555,Oceania,16190,2009
6358,22548,6.345,New Zealand,NZL,6.345,82.604,4803,1555,Oceania,16190,2009
6358,22548,6.345,New Zealand,NZL,6.345,82.604,4803,1555,Oceania,16190,2009
6358,22548,6.345,New Zealand,NZL,6.345,82.604,4803,1555,Oceania,16190,2009
6358,22548,6.345,New Zealand,NZL,6.345,82.604,4803,1555,Oceania,16190,2009
6358,22548,6.345,New Zealand,NZL,6.345,82.604,4803,1555,Oceania,16190,2009
6358,22548,6.345,New Zealand,NZL,6.345,82.604,4803,1555,Oceania,16190,2009
6636,23760,7.053,New Zealand,NZL,7.053,82.518,5051,1585,Oceania,17124,2010
6636,23760,7.053,New Zealand,NZL,7.053,82.518,5051,1585,Oceania,17124,2010
6636,23760,7.053,New Zealand,NZL,7.053,82.518,5051,1585,Oceania,17124,2010
6636,23760,7.053,New Zealand,NZL,7.053,82.518,5051,1585,Oceania,17124,2010
6636,23760,7.053,New Zealand,NZL,7.053,82.518,5051,1585,Oceania,17124,2010
6636,23760,7.053,New Zealand,NZL,7.053,82.518,5051,1585,Oceania,17124,2010
6636,23760,7.053,New Zealand,NZL,7.053,82.518,5051,1585,Oceania,17124,2010
6209,23957,6.999,New Zealand,NZL,6.999,81.707,4708,1501,Oceania,17748,2011
6209,23957,6.999,New Zealand,NZL,6.999,81.707,4708,1501,Oceania,17748,2011
6209,23957,6.999,New Zealand,NZL,6.999,81.707,4708,1501,Oceania,17748,2011
6209,23957,6.999,New Zealand,NZL,6.999,81.707,4708,1501,Oceania,17748,2011
6209,23957,6.999,New Zealand,NZL,6.999,81.707,4708,1501,Oceania,17748,2011
6209,23957,6.999,New Zealand,NZL,6.999,81.707,4708,1501,Oceania,17748,2011
6209,23957,6.999,New Zealand,NZL,6.999,81.707,4708,1501,Oceania,17748,2011
7099,25126,7.253,New Zealand,NZL,7.253,80.843,5674,1425,Oceania,18027,2012
7099,25126,7.253,New Zealand,NZL,7.253,80.843,5674,1425,Oceania,18027,2012
7099,25126,7.253,New Zealand,NZL,7.253,80.843,5674,1425,Oceania,18027,2012
7099,25126,7.253,New Zealand,NZL,7.253,80.843,5674,1425,Oceania,18027,2012
7099,25126,7.253,New Zealand,NZL,7.253,80.843,5674,1425,Oceania,18027,2012
7099,25126,7.253,New Zealand,NZL,7.253,80.843,5674,1425,Oceania,18027,2012
7099,25126,7.253,New Zealand,NZL,7.253,80.843,5674,1425,Oceania,18027,2012
6781,25557,4.825500000,New Zealand,NZL,0,79.714,5167,1614,Oceania,18776,2013
6781,25557,4.825500000,New Zealand,NZL,0,79.714,5167,1614,Oceania,18776,2013
6781,25557,4.825500000,New Zealand,NZL,0,79.714,5167,1614,Oceania,18776,2013
6781,25557,4.825500000,New Zealand,NZL,0,79.714,5167,1614,Oceania,18776,2013
6781,25557,4.825500000,New Zealand,NZL,0,79.714,5167,1614,Oceania,18776,2013
6781,25557,4.825500000,New Zealand,NZL,0,79.714,5167,1614,Oceania,18776,2013
6781,25557,4.825500000,New Zealand,NZL,0,79.714,5167,1614,Oceania,18776,2013
7728,28303,4.825500000,New Zealand,NZL,0,0,6092,1636,Oceania,20575,2014
7728,28303,4.825500000,New Zealand,NZL,0,0,6092,1636,Oceania,20575,2014
7728,28303,4.825500000,New Zealand,NZL,0,0,6092,1636,Oceania,20575,2014
7728,28303,4.825500000,New Zealand,NZL,0,0,6092,1636,Oceania,20575,2014
7728,28303,4.825500000,New Zealand,NZL,0,0,6092,1636,Oceania,20575,2014
7728,28303,4.825500000,New Zealand,NZL,0,0,6092,1636,Oceania,20575,2014
7728,28303,4.825500000,New Zealand,NZL,0,0,6092,1636,Oceania,20575,2014
0,0,4.825500000,New Zealand,NZL,0,0,0,0,Oceania,0,2015
0,0,4.825500000,New Zealand,NZL,0,0,0,0,Oceania,0,2015
0,0,4.825500000,New Zealand,NZL,0,0,0,0,Oceania,0,2015
0,0,4.825500000,New Zealand,NZL,0,0,0,0,Oceania,0,2015
0,0,4.825500000,New Zealand,NZL,0,0,0,0,Oceania,0,2015
0,0,4.825500000,New Zealand,NZL,0,0,0,0,Oceania,0,2015
0,0,4.825500000,New Zealand,NZL,0,0,0,0,Oceania,0,2015
